58 13 55 66 17 19 60 15 53 53 8 11 41 61 64 53 60 57 43 12 13 20 57 54 12 16 66 19 58 35 52 10 17 7 40 68 50 16 59 10 67 54 68 75 50 57 64 52 10 72 60 46 75 16 13 53 57 54 52 10 52 78 54 49 60 48 10 14 54 56 62 62 59 69 14 41 65 71 47 81 74 48 68 10 55 55 55 63 21 70 11 62 18 58 65 53 15 18 47 56
65 14 20 12 53 54 63 16 50 14 61 12 45 50 68 44 14 61 65 67 58 58 13 21 56 63 69 59 56 68 60 60 18 58 71 14 52 56 49 81 13 17 80 13 59 55 61 60 61 12 71 50 57 58 61 16 51 66 60 19 12 51 67 15 14 15 71 65 60 47 16 22 63 70 54 61 51 18 61 57 50 55 59 69 65 53 71 54 58 10 47 22 55 7 66 13 46 62 18 62
76 69 67 68 66 19 54 17 63 19 69 69 21 49 71 17 59 59 55 57 55 9 58 67 12 69 62 14 58 14 50 45 60 62 67 57 64 47 61 61 61 51 59 15 17 63 53 64 60 58 61 66 17 52 14 14 44 54 16 18 57 50 12 22 28 69 58 69 60 51 69 47 74 16 62 70 60 55 16 64 50 55 72 69 76 76 45 11 55 68 75 65 16 53 49 77 70 55 10 56
18 79 18 17 44 77 21 17 67 17 59 71 17 52 60 55 52 63 54 62 14 68 51 52 12 50 53 54 12 63 68 48 12 47 57 47 69 14 54 67 46 66 69 65 58 77 69 68 74 42 73 70 66 77 58 49 54 53 52 72 76 21 70 17 51 53 59 49 62 14 22 16 55 15 41 57 77 56 72 16 69 20 14 54 54 11 65 64 16 78 13 14 48 51 60 19 11 60 20 73
58 16 45 35 56 72 68 62 49 63 84 53 55 17 11 16 13 43 44 63 17 47 50 73 51 15 70 18 84 52 15 17 62 81 44 40 58 19 79 69 15 14 11 53 12 49 53 60 16 72 14 19 56 51 78 20 15 61 83 23 53 48 17 56 45 52 72 62 60 12 65 54 60 15 12 55 70 48 57 68 57 64 67 45 15 51 55 11 21 65 47 57 54 57 80 17 62 74 66 21
17 80 62 12 57 45 81 72 63 65 59 46 64 57 60 55 75 18 69 49 74 21 59 15 54 13 59 18 49 73 58 53 84 13 17 55 48 54 63 46 51 12 78 48 61 54 62 13 65 80 54 61 46 11 72 11 70 16 16 62 70 74 14 59 68 17 59 53 17 18 20 58 48 71 17 14 18 14 61 66 68 15 12 49 18 11 63 53 73 69 55 12 57 67 21 63 48 12 74 33
69 9 41 56 56 12 73 20 57 58 53 22 59 56 65 17 77 68 57 18 58 58 59 73 15 17 64 13 54 57 59 58 47 46 50 60 52 11 35 57 16 45 52 47 56 53 54 15 64 66 16 61 15 44 52 54 64 65 57 50 50 14 52 57 55 43 68 19 68 83 64 58 43 55 64 60 63 59 51 65 64 61 17 71 54 69 46 65 20 13 82 69 13 40 18 14 13 19 67 48
76 53 13 17 72 19 61 52 54 10 51 14 16 65 58 60 15 59 42 63 43 12 52 68 59 16 50 58 13 72 63 60 21 16 65 14 72 53 61 57 20 13 12 70 62 49 64 72 13 62 16 72 69 51 38 62 11 19 13 64 46 20 65 71 70 62 66 49 28 61 64 12 74 58 57 11 53 43 11 69 60 64 55 62 50 67 13 71 78 57 17 71 64 62 62 17 58 70 72 11
59 51 10 15 56 65 57 51 58 48 56 66 13 65 41 73 73 52 70 70 66 84 68 65 44 69 69 43 74 53 51 52 17 76 61 13 42 12 72 73 18 56 63 54 51 43 52 55 16 72 63 16 84 55 58 52 12 66 65 67 47 63 50 46 72 56 63 16 71 68 61 15 49 57 14 17 74 16 61 45 54 74 62 12 19 17 35 12 50 68 56 69 45 12 59 61 50 15 67 46
51 19 57 58 50 13 70 14 11 14 18 64 61 63 64 9 20 51 71 22 74 12 73 59 49 52 12 13 61 64 65 17 58 59 56 61 64 66 57 46 49 9 14 57 22 59 66 13 50 11 11 54 10 17 61 62 17 12 8 54 23 77 9 61 54 71 10 45 70 60 53 13 56 17 61 15 13 54 11 78 43 21 65 14 16 48 14 14 62 43 71 74 52 57 59 56 22 60 10 57
69 12 61 64 57 58 56 8 53 56 20 14 48 59 63 50 65 11 77 63 67 13 10 46 72 59 19 56 56 61 17 76 57 17 18 50 52 58 46 14 69 56 58 60 64 17 56 63 53 64 59 69 12 15 78 66 57 58 18 64 48 62 68 16 51 63 61 69 52 54 74 68 56 63 13 54 58 20 15 52 12 77 20 19 51 59 60 58 54 65 15 73 75 16 45 54 50 62 70 62
56 63 17 61 72 53 68 57 46 71 50 50 54 75 14 11 65 65 80 85 21 57 42 20 18 18 64 17 62 67 57 57 18 15 8 15 55 69 63 44 57 18 59 17 16 60 19 64 70 15 76 59 62 13 53 75 56 58 56 59 53 44 49 19 13 57 61 66 58 65 14 63 48 60 6 58 56 64 55 62 49 67 66 60 57 51 72 66 9 15 21 54 54 69 18 68 17 76 57 63
62 65 85 15 18 41 16 50 15 63 20 15 44 21 18 52 62 12 39 61 56 60 75 73 71 53 59 10 81 60 56 52 9 66 73 23 65 60 62 16 19 68 49 44 44 51 48 55 15 63 53 22 78 64 59 77 62 54 69 57 48 75 67 74 15 63 45 57 49 56 58 16 61 48 82 72 13 57 68 45 61 66 18 18 18 39 53 59 59 14 13 57 60 61 54 56 73 11 17 49
64 25 80 50 53 17 11 55 12 49 15 10 42 21 12 55 52 62 18 15 65 61 47 60 75 49 77 60 20 55 62 19 14 59 70 22 18 71 12 45 15 75 61 61 8 61 69 39 54 72 48 56 53 49 45 23 19 57 57 22 69 71 45 65 60 49 56 67 16 56 51 47 61 49 22 13 57 13 16 72 13 17 14 62 12 55 62 16 19 54 69 73 47 73 58 37 16 64 14 12
53 58 55 54 16 58 21 64 68 61 55 7 50 52 51 17 24 66 11 53 19 20 10 51 58 82 51 13 13 40 63 55 62 56 16 51 17 61 66 47 55 50 58 40 46 14 68 62 45 54 15 10 11 19 47 81 13 59 65 7 76 44 62 68 18 49 48 45 62 19 16 57 10 65 52 51 67 15 15 39 59 60 56 18 58 61 56 55 66 64 40 53 16 8 49 56 82 45 66 58
61 19 18 74 81 68 14 46 52 70 13 67 59 47 23 46 46 64 15 57 60 16 65 17 11 63 50 52 15 15 54 63 58 56 12 61 13 56 13 49 61 10 54 48 20 16 15 53 65 18 60 80 21 52 48 22 64 53 11 79 53 64 52 17 51 24 61 67 63 44 70 16 55 64 14 45 53 50 10 18 71 16 55 47 63 17 50 55 53 65 14 54 13 53 59 54 77 60 76 15
56 69 58 18 64 58 63 48 60 49 24 62 58 63 52 14 63 63 59 68 54 53 50 14 42 63 20 54 52 76 56 50 15 79 14 18 60 64 22 58 59 52 61 48 16 17 55 20 54 66 66 70 56 63 50 56 54 24 56 48 16 55 68 59 12 13 58 22 52 16 62 53 55 56 16 60 56 53 69 67 51 55 66 75 72 55 42 62 51 20 11 69 55 19 52 23 62 64 74 57
48 59 56 52 81 21 65 77 13 19 58 50 24 71 13 50 68 7 85 60 67 65 11 67 61 61 18 61 57 12 12 13 77 64 68 54 47 20 22 56 76 59 69 44 15 18 13 79 44 20 17 62 9 42 55 59 25 19 53 55 50 66 57 62 36 15 64 56 57 65 51 15 41 65 46 53 39 13 14 54 61 21 17 53 52 15 12 11 18 15 58 16 61 57 74 36 16 76 59 51
75 82 59 64 16 56 63 62 63 61 46 59 76 65 62 52 55 61 59 62 63 68 66 67 73 65 52 14 62 57 49 76 64 70 14 58 54 58 44 75 16 53 12 14 43 76 12 46 57 78 48 19 60 66 62 12 43 44 50 61 54 63 21 14 48 13 58 45 19 59 57 15 9 12 14 18 55 67 61 67 73 44 51 77 54 69 56 48 50 53 58 58 17 59 42 10 69 69 55 46
61 20 53 16 56 58 65 50 10 43 59 65 63 20 12 55 56 61 14 51 70 61 53 19 60 14 44 18 63 60 68 69 69 51 73 16 65 60 70 51 36 55 61 44 7 57 17 51 57 61 15 26 56 70 14 68 61 9 49 68 79 66 67 85 11 16 53 16 61 10 55 57 25 20 19 66 63 72 59 13 59 57 55 59 48 13 22 18 56 59 69 56 70 23 12 68 15 20 57 60
11 55 58 65 27 56 14 55 53 14 64 84 53 56 19 53 15 65 61 44 14 16 59 56 51 72 63 50 58 44 79 64 49 15 17 51 86 72 54 67 43 19 79 48 13 51 8 20 53 49 45 79 17 16 57 55 65 13 71 54 64 64 54 58 18 61 19 28 76 11 17 63 11 66 71 23 75 76 53 7 53 66 18 62 57 5 58 80 79 17 17 14 48 58 68 59 19 45 67 58
22 60 6 16 80 53 81 38 63 48 49 54 55 44 59 49 77 14 44 54 41 16 59 69 12 54 55 66 63 64 21 65 20 9 15 71 17 53 12 67 47 12 14 56 45 64 74 18 56 55 68 61 16 17 66 20 57 67 59 14 15 53 60 59 58 65 13 59 48 15 55 53 64 57 49 51 62 13 49 60 22 60 12 42 60 53 21 8 45 41 61 43 57 79 24 57 14 15 62 56
15 17 58 10 16 68 17 65 28 12 74 66 70 62 54 53 59 63 12 64 12 19 64 45 21 49 48 68 15 62 14 53 54 48 64 21 71 20 52 62 56 67 56 67 17 64 43 12 60 60 79 61 18 40 74 15 56 64 21 11 11 16 41 49 62 59 69 59 59 53 70 16 44 65 72 15 58 56 44 61 63 44 17 54 53 49 57 13 21 13 46 59 17 15 56 55 18 47 43 10
45 63 66 57 59 44 61 61 64 55 60 51 18 60 54 15 61 20 50 44 73 17 52 54 66 17 55 57 58 54 17 12 54 17 54 43 24 13 61 63 52 42 57 52 78 68 46 53 45 16 11 21 69 63 62 57 47 8 63 9 20 65 73 56 58 58 49 67 57 20 66 50 68 21 3 62 66 57 8 62 72 15 55 72 16 48 74 60 60 60 14 69 69 11 71 22 58 52 71 59
18 16 20 65 55 52 55 55 56 15 17 60 48 53 17 44 17 23 14 76 41 52 52 50 64 53 13 50 20 61 17 17 51 58 71 16 61 59 62 56 69 63 57 14 12 38 58 48 63 53 70 60 60 13 50 66 18 76 70 60 71 65 15 48 52 68 77 18 64 7 63 63 15 60 63 22 63 50 43 43 14 59 55 64 50 63 19 71 58 54 79 64 64 52 62 56 58 58 60 21
16 68 66 51 60 54 62 25 10 19 54 59 55 58 24 71 62 58 21 39 53 47 14 14 10 10 56 13 68 59 56 57 67 19 69 10 49 65 60 60 11 63 14 57 61 14 9 16 55 80 67 68 43 40 48 66 14 57 17 73 13 39 52 59 17 76 60 56 31 68 67 62 73 79 17 23 21 53 40 16 17 60 63 60 16 61 59 21 13 61 59 100 10 11 12 72 54 49 62 13
17 57 66 69 12 20 20 20 62 60 66 53 61 61 60 51 54 47 19 61 63 6 52 20 56 64 55 62 13 52 72 13 18 13 68 64 13 64 71 55 60 59 58 16 70 74 54 65 46 17 44 60 44 48 14 14 55 59 49 13 77 14 58 65 14 64 19 41 48 57 14 56 54 48 80 12 18 75 74 58 60 68 56 40 56 18 20 68 57 20 46 70 18 73 55 53 78 10 66 51
17 70 53 47 58 71 65 59 10 46 55 13 11 48 12 53 13 19 56 14 23 58 57 82 11 52 50 45 59 16 55 60 53 50 60 9 53 14 64 55 72 51 53 55 15 57 49 5 69 55 15 71 23 64 73 57 17 56 14 17 56 65 13 44 22 16 65 79 52 14 17 62 62 51 75 57 54 60 83 68 17 21 18 57 69 47 55 48 21 13 43 64 13 67 64 63 16 55 13 15
53 21 69 53 68 68 52 15 66 59 62 63 47 11 56 43 53 75 56 57 58 12 74 56 49 46 15 16 64 18 24 11 67 50 24 50 62 49 51 14 71 60 15 61 52 18 16 59 77 65 46 68 60 11 52 63 19 48 70 15 66 64 73 58 54 19 10 62 53 52 61 64 68 13 63 65 63 23 72 69 50 15 59 58 13 56 18 16 64 55 50 23 17 58 66 37 54 37 9 15
53 68 52 10 65 68 54 80 54 65 55 13 9 17 62 14 19 51 70 47 65 55 16 65 29 63 14 56 12 61 21 17 54 22 20 65 15 15 57 70 12 11 58 66 8 54 55 14 71 49 76 51 53 8 58 58 14 53 58 60 63 64 77 48 56 69 54 66 20 62 69 70 68 18 64 53 20 54 21 39 13 44 50 71 50 64 12 20 53 14 53 49 49 54 57 52 53 21 67 8
68 13 50 70 11 13 53 62 60 70 63 14 35 80 17 19 7 56 59 66 48 60 66 53 12 56 66 55 67 17 8 26 12 55 59 17 58 18 89 51 56 19 49 53 51 49 49 53 18 16 53 57 17 70 57 16 56 19 40 54 20 50 19 62 59 48 69 66 13 58 50 70 73 62 12 57 59 61 51 11 68 11 67 48 55 60 41 14 63 67 48 49 58 17 14 55 52 53 47 50
44 14 67 81 13 56 16 15 61 73 59 64 67 10 57 17 64 51 17 48 67 19 58 65 57 16 54 68 13 45 23 54 69 53 19 51 46 7 59 44 66 58 10 55 17 21 68 42 43 61 50 66 48 15 51 58 65 73 22 16 18 66 67 53 56 50 14 19 19 11 46 51 58 54 56 21 7 56 51 53 63 23 48 67 69 15 48 59 76 62 61 74 14 7 16 15 49 59 56 54
14 57 17 45 14 49 64 11 13 52 42 17 61 60 54 52 59 54 49 67 52 64 77 11 51 48 53 64 18 52 59 15 59 41 17 54 64 16 69 69 51 55 74 52 20 73 49 30 59 17 13 57 51 71 25 19 59 15 61 18 62 64 53 61 67 15 57 54 14 59 75 57 19 13 53 60 66 10 60 13 62 18 61 10 52 9 58 26 62 19 68 55 18 65 14 53 51 62 59 45
52 67 57 54 12 17 39 55 69 58 67 13 48 65 24 73 55 19 15 12 60 21 18 14 53 19 17 54 56 49 14 18 58 70 14 56 62 43 63 20 20 16 54 76 77 9 15 56 68 16 72 17 53 64 17 19 61 14 14 43 79 51 70 63 61 54 16 55 21 31 19 70 42 58 64 51 58 49 50 57 17 53 70 43 18 55 17 17 61 65 24 58 64 70 65 49 57 51 65 67
63 54 47 14 46 61 24 46 55 50 63 82 55 55 56 48 55 70 54 69 70 55 54 54 15 14 46 69 16 20 46 17 63 57 22 52 58 81 69 16 56 25 58 85 20 55 58 62 56 14 16 24 65 13 59 53 54 68 40 83 42 79 76 53 83 78 60 61 58 59 19 68 56 62 52 17 44 62 47 48 44 45 49 8 50 65 60 16 10 12 50 68 17 59 66 48 66 58 67 51
13 64 67 70 62 63 62 23 72 66 17 15 67 66 15 15 17 61 57 48 55 15 54 67 55 49 20 56 35 15 67 14 49 59 49 16 56 62 60 7 44 25 67 74 62 57 51 84 49 60 72 17 58 61 64 12 55 17 57 57 62 62 16 65 72 51 66 16 38 46 62 51 56 68 47 12 59 57 63 57 13 60 47 52 69 53 58 57 22 71 72 68 17 13 10 17 55 66 80 65
53 57 13 50 59 61 21 59 65 61 13 54 59 46 51 33 58 64 62 21 12 18 9 18 57 20 16 47 19 14 17 54 53 60 43 49 60 13 69 20 48 45 18 58 56 70 16 16 70 54 74 11 19 51 66 60 70 10 15 14 66 63 50 17 70 8 12 50 58 53 49 7 58 23 17 47 12 61 45 73 43 7 68 62 75 73 48 21 13 16 60 57 72 14 21 11 53 15 67 56
46 11 17 59 71 69 51 15 76 59 17 69 52 51 20 63 18 61 60 61 17 23 55 57 57 11 22 9 55 56 56 64 65 17 62 14 63 70 14 23 62 53 21 12 50 54 52 56 56 16 36 50 60 13 8 20 67 72 57 65 56 53 68 54 79 15 17 18 63 68 64 21 19 57 50 14 13 10 11 53 55 60 49 58 64 63 52 75 62 11 62 62 62 20 58 43 67 40 54 77
62 13 10 74 12 74 55 50 26 72 59 63 73 13 56 63 14 57 71 62 68 70 7 21 52 65 48 49 16 52 52 58 14 57 16 15 64 46 57 60 50 18 42 13 11 13 17 16 63 6 43 64 56 68 74 72 59 11 70 77 15 59 45 43 61 14 72 48 21 57 68 51 64 21 12 90 67 12 15 13 71 63 12 57 49 50 50 57 62 56 67 16 55 44 61 51 55 17 56 59
21 47 12 18 20 58 20 72 52 61 72 80 48 12 58 61 56 55 51 63 8 51 49 64 63 69 9 11 81 21 49 44 55 58 63 15 62 63 19 76 64 63 15 52 20 22 60 62 44 13 52 71 58 83 63 52 64 59 73 17 83 15 48 17 70 16 53 16 58 10 48 52 56 49 65 81 57 12 59 60 46 54 69 56 66 15 50 53 75 12 14 64 47 67 62 64 40 60 51 66
72 72 51 68 60 54 14 65 20 56 63 59 43 54 67 67 65 62 50 58 59 64 16 70 8 57 59 72 68 62 16 60 15 61 57 67 16 56 11 45 17 54 73 36 53 56 60 60 68 21 18 66 21 62 19 11 54 17 45 16 16 54 18 55 10 51 51 57 25 18 47 53 56 17 11 66 64 57 15 63 25 52 74 18 71 33 55 52 15 13 64 53 14 51 59 12 74 42 62 44
53 60 20 54 56 54 21 46 62 59 18 55 59 76 57 54 58 20 15 58 64 36 14 57 62 52 65 67 51 14 68 21 53 60 24 65 71 16 64 17 14 50 13 71 71 69 11 53 68 51 63 51 12 56 57 61 81 52 69 62 63 56 15 55 60 54 21 21 12 63 13 69 12 62 61 11 60 50 57 43 62 9 76 17 61 62 63 18 69 68 62 50 69 22 53 23 16 43 64 61
19 63 53 7 57 19 50 61 64 48 56 21 54 54 53 71 20 43 60 56 11 61 49 46 62 70 60 66 19 48 15 62 56 59 13 57 73 59 65 15 94 14 74 49 71 15 67 62 21 15 71 60 8 63 80 49 45 14 65 11 52 18 77 19 54 19 66 47 56 56 47 19 63 25 21 15 16 16 10 51 59 55 61 60 55 54 64 14 13 19 78 23 16 20 19 10 62 59 61 59
13 64 72 65 53 64 22 52 71 16 75 53 24 53 85 55 64 63 14 41 15 17 58 15 76 14 13 15 55 70 77 63 58 18 84 58 54 58 17 62 13 55 76 59 60 15 49 50 60 67 75 66 13 49 45 18 63 19 19 68 56 75 59 22 49 14 68 53 14 42 18 50 60 51 17 47 62 12 10 64 15 63 14 52 61 76 56 50 58 68 21 64 14 64 52 56 61 51 80 73
71 53 42 59 63 47 55 49 16 14 55 15 59 63 68 57 14 62 59 53 53 76 14 43 59 61 71 14 74 73 61 20 65 72 58 47 46 79 53 20 63 52 53 57 18 12 51 71 54 19 18 61 66 51 19 48 21 52 12 75 51 12 68 69 41 51 47 57 65 85 11 12 12 57 48 62 57 17 23 66 65 55 14 16 45 15 65 66 58 64 15 62 71 16 51 63 40 10 58 68
50 20 63 60 69 56 57 74 22 16 14 73 18 18 65 52 48 80 50 56 61 59 55 21 10 63 19 103 55 60 44 14 54 20 8 58 53 18 54 81 52 40 13 16 40 53 67 54 58 72 20 57 56 21 44 40 69 50 66 66 54 61 49 61 63 20 18 17 68 14 44 72 74 61 55 59 58 58 65 25 20 56 43 54 45 61 59 53 51 64 16 64 17 52 10 11 10 67 52 60
56 48 46 69 53 66 68 15 12 77 37 58 40 52 74 61 22 60 20 65 21 66 64 18 40 10 58 12 11 51 48 57 47 10 11 60 16 58 59 47 12 60 19 77 63 64 53 17 46 20 13 56 48 65 51 62 14 21 71 14 46 69 76 17 58 55 16 56 60 72 61 47 16 25 13 53 12 52 11 69 51 25 45 47 14 53 12 62 61 18 16 53 52 16 46 17 63 8 24 52
54 51 69 63 55 38 64 63 14 21 17 17 16 49 58 59 66 15 15 60 14 49 11 63 9 60 63 19 61 15 13 60 55 60 58 22 80 59 18 16 16 14 47 53 50 71 58 55 44 54 47 52 20 60 67 15 59 63 49 52 11 63 58 67 14 63 11 59 15 44 59 16 53 21 17 70 65 55 14 53 21 57 15 14 60 55 63 11 17 57 49 57 63 79 71 55 60 10 54 16
60 17 48 73 17 69 14 50 20 62 53 18 54 20 11 57 53 64 53 14 22 40 13 14 14 63 49 68 69 22 23 19 60 51 50 63 42 15 63 65 56 65 55 18 22 64 59 76 64 82 57 68 46 71 63 69 11 15 13 22 44 11 52 60 64 8 53 53 16 21 77 13 9 52 75 69 68 17 66 18 59 59 64 50 15 60 16 52 67 12 67 74 21 45 58 13 67 13 26 54
51 15 67 12 12 49 13 73 16 65 58 43 62 43 49 67 46 66 58 10 11 17 20 55 52 49 55 63 75 15 55 11 19 60 16 15 59 65 52 22 52 33 64 54 57 67 50 14 60 12 53 19 54 24 15 58 60 66 49 62 67 16 12 15 17 15 61 58 19 57 63 52 61 61 15 55 23 17 58 11 64 18 63 68 14 60 63 52 61 15 66 57 64 14 20 50 20 15 77 47
16 58 63 16 53 56 71 50 89 14 19 65 53 13 58 60 65 58 24 11 18 50 57 6 49 52 64 13 26 67 19 57 60 49 56 66 51 64 9 62 61 75 13 55 56 65 19 62 61 69 55 58 17 17 80 70 15 52 20 51 59 53 60 58 15 69 17 17 57 71 54 70 52 74 64 54 55 14 62 15 20 65 54 76 60 23 69 54 65 64 23 50 67 45 57 45 58 21 65 54
42 17 54 53 69 68 67 58 15 58 55 39 67 22 12 57 18 59 59 24 55 14 17 63 48 60 68 59 17 65 9 17 58 13 10 25 64 48 36 75 13 51 54 62 10 48 12 49 62 39 61 53 58 64 53 60 14 58 73 53 11 79 48 62 76 9 58 49 73 60 61 64 51 6 63 58 55 15 52 56 14 54 16 7 40 55 9 63 56 11 55 15 59 55 60 51 73 52 46 50
63 74 17 57 22 57 39 19 44 11 63 66 77 18 58 55 58 66 71 50 66 13 49 55 53 26 50 54 10 57 12 80 54 19 53 59 52 80 7 59 23 56 25 11 15 16 52 60 62 46 66 10 67 64 21 17 60 66 52 24 58 58 52 66 22 61 82 53 63 18 59 66 60 64 66 55 53 52 12 13 68 56 45 56 60 50 12 62 59 55 49 65 66 52 14 17 47 72 55 59
16 51 62 64 56 61 74 13 56 52 69 18 70 51 86 41 15 59 57 19 14 60 13 63 79 54 74 50 52 45 48 62 47 13 59 43 22 52 68 59 62 55 15 53 16 13 58 13 13 55 13 67 15 14 14 64 20 15 11 50 50 58 19 12 79 43 18 63 54 54 51 46 14 11 70 53 56 71 56 55 12 19 58 23 8 18 53 65 24 14 60 55 72 53 83 54 64 57 13 10
16 66 58 67 59 58 19 68 19 63 65 65 65 13 19 59 47 68 58 60 15 61 58 65 18 74 62 58 79 49 51 49 64 16 50 73 57 53 14 72 16 48 36 69 72 12 70 75 59 54 20 53 12 62 62 56 18 63 48 72 17 64 55 17 45 53 13 51 22 66 73 59 21 58 65 69 12 64 63 8 51 17 42 20 8 73 15 55 20 16 60 62 58 53 42 8 18 61 16 14
54 51 14 18 53 64 12 56 63 53 66 12 60 17 53 47 64 12 14 11 48 48 70 84 12 78 70 72 55 9 79 53 15 14 17 47 51 13 20 56 64 17 13 10 59 57 46 50 58 62 58 16 68 63 47 56 58 11 56 56 62 66 81 65 52 17 68 48 41 55 63 61 63 54 62 14 10 53 53 52 18 57 68 67 57 68 51 51 39 50 69 54 82 18 66 47 64 45 58 58
58 57 53 16 16 59 60 63 63 13 56 75 65 73 15 66 63 76 70 55 16 63 15 54 57 12 55 54 74 40 16 73 61 17 55 78 52 14 65 58 22 15 55 61 51 85 45 46 54 19 68 66 14 55 18 75 57 70 58 63 16 72 17 46 59 63 22 68 60 13 56 61 66 68 61 9 20 76 52 68 50 20 48 22 56 11 12 15 54 67 70 69 76 10 57 24 61 51 13 17
64 53 66 63 68 53 50 50 12 62 60 12 63 53 60 52 63 62 58 56 52 65 78 58 60 68 17 56 73 53 49 71 81 59 52 72 20 69 51 77 60 14 12 51 61 69 50 17 15 15 62 57 63 13 54 55 17 12 61 19 53 53 52 69 53 63 75 63 56 47 17 87 53 56 23 58 26 46 22 17 64 10 58 54 61 56 17 50 59 16 71 58 56 17 72 14 62 44 55 64
66 59 65 55 55 47 59 13 63 15 69 9 76 50 60 61 13 48 53 61 63 53 13 49 20 47 50 72 76 23 80 51 12 18 79 69 10 18 58 23 64 74 56 49 70 36 55 53 65 16 65 74 61 60 18 71 72 51 58 55 15 60 21 42 12 71 56 12 58 23 13 58 51 14 56 18 81 65 12 54 67 14 42 47 16 66 64 62 81 18 72 61 64 75 68 17 14 53 60 44
54 61 63 65 16 18 51 56 50 49 70 62 12 55 49 11 19 59 52 72 18 74 75 54 18 50 58 20 11 46 19 50 60 16 57 54 78 50 17 54 23 53 57 67 49 69 54 47 10 21 64 57 71 58 51 48 16 73 54 64 19 70 62 61 9 54 46 51 55 56 59 16 10 45 54 72 57 14 53 59 64 59 46 19 18 72 16 62 53 48 51 15 55 62 57 66 68 64 49 7
24 56 85 73 53 61 13 58 51 17 14 45 43 51 46 60 16 9 61 49 18 65 15 15 58 57 37 64 61 14 58 54 73 47 64 39 55 55 53 70 26 48 67 14 67 55 47 16 12 22 46 53 17 60 75 8 77 82 15 14 35 45 69 65 70 22 67 62 59 66 66 51 56 85 57 15 54 57 13 57 84 15 19 81 46 14 59 68 12 46 57 12 46 56 62 17 14 18 60 64
59 43 53 35 54 14 62 15 70 50 63 66 66 69 20 50 73 50 74 20 58 54 64 18 53 69 56 54 76 45 62 13 62 60 21 58 69 61 64 61 64 55 68 62 37 54 49 58 13 57 54 54 14 72 49 9 49 70 11 47 48 52 47 56 53 15 14 17 13 71 21 66 52 68 52 57 50 61 50 62 62 81 56 48 19 57 12 51 53 57 59 60 48 61 49 13 63 54 11 58
14 59 64 65 15 62 64 67 61 49 73 77 49 48 14 65 62 59 15 53 57 65 17 49 11 15 54 62 82 16 59 8 16 50 55 62 71 16 59 17 64 55 67 42 64 57 65 15 20 58 17 19 74 66 16 72 71 16 52 66 62 12 61 19 16 61 61 15 46 14 67 53 9 18 9 73 13 62 53 57 15 14 17 68 15 23 53 14 59 58 51 62 66 54 14 54 71 54 58 51
52 63 44 45 53 58 13 57 16 47 15 60 18 64 62 55 52 15 75 72 19 14 53 53 52 58 68 57 64 54 60 20 12 16 10 65 50 46 81 54 50 64 24 15 47 59 63 50 17 17 10 63 6 46 49 54 14 62 39 14 61 78 19 61 71 15 51 71 64 17 67 16 62 52 52 57 49 55 14 15 58 71 14 51 47 18 12 64 61 54 59 40 45 62 19 61 59 20 15 56
53 13 54 15 59 10 19 18 74 19 18 56 41 64 14 42 13 66 46 51 21 22 65 52 15 61 64 19 39 71 63 14 8 18 14 75 57 45 63 60 65 49 53 66 60 60 52 17 20 15 55 49 45 12 18 74 67 72 48 77 53 57 16 58 17 63 67 62 63 53 57 61 77 76 12 15 53 19 69 57 17 59 13 57 58 55 63 66 52 57 50 62 68 14 58 11 49 13 14 17
72 76 16 58 61 53 19 59 49 60 14 72 50 59 57 65 59 68 48 65 11 59 77 21 17 48 53 64 55 59 45 45 71 69 16 18 70 22 64 53 64 15 50 66 45 53 13 13 64 18 60 63 44 70 13 56 67 62 11 64 65 57 13 42 10 21 54 59 54 71 53 66 54 69 68 13 18 18 65 72 22 62 58 48 64 46 56 11 63 14 59 63 46 76 54 62 51 51 55 74
54 18 66 65 15 78 15 69 20 60 13 59 53 59 68 15 83 53 62 59 55 62 58 62 20 61 14 53 16 51 46 20 16 61 55 83 67 69 58 57 18 59 60 56 54 50 63 67 18 47 66 65 13 56 65 17 24 12 67 44 61 24 19 52 80 40 13 77 61 50 14 72 13 18 25 17 55 41 58 60 16 66 17 64 54 66 14 18 48 13 50 50 61 61 54 59 66 63 87 72
60 64 59 18 70 55 69 59 53 60 39 57 48 50 67 15 74 60 54 18 64 25 7 55 61 76 17 11 24 51 52 60 56 67 52 58 61 16 83 20 59 54 13 69 18 62 63 22 13 19 61 66 63 18 66 53 11 11 69 60 56 58 17 19 46 8 19 46 58 83 59 46 54 20 42 67 9 13 73 15 17 20 71 57 71 50 9 8 8 80 61 67 58 63 55 58 16 66 43 60
50 67 12 55 60 55 50 44 42 14 68 58 60 49 54 64 59 19 56 67 60 58 21 19 20 61 18 65 62 73 71 11 13 10 14 56 77 14 53 64 15 61 68 64 26 56 59 64 13 59 62 14 67 57 15 65 58 55 55 14 71 56 14 20 52 58 12 72 44 70 60 49 16 56 41 53 67 58 70 18 56 50 55 20 57 22 73 62 65 13 57 52 62 51 62 68 58 57 68 40
53 52 12 63 53 50 52 18 61 53 46 69 12 63 16 60 12 78 48 64 62 58 54 13 48 21 4 60 55 72 59 12 24 25 51 14 12 13 9 16 63 62 50 51 69 69 70 17 10 80 57 17 50 65 59 52 65 21 13 20 18 55 76 53 59 59 65 52 73 15 56 56 75 73 16 66 20 20 14 18 58 54 54 49 52 15 58 12 20 8 18 54 67 49 22 67 64 58 59 17
56 74 48 50 12 13 53 73 49 50 56 50 45 66 69 60 44 74 9 52 58 93 12 16 49 13 64 51 58 14 12 58 16 51 54 52 59 60 48 10 62 47 6 65 69 47 10 50 62 18 62 12 58 54 73 66 52 42 69 66 70 15 61 71 40 52 65 18 54 58 41 59 58 51 14 74 78 62 78 15 49 19 57 60 59 52 67 59 40 22 85 12 55 44 61 67 71 11 81 20
65 47 67 60 11 22 48 43 20 52 60 68 11 16 14 54 50 50 57 52 17 58 17 54 18 62 49 18 15 65 11 55 73 53 10 12 60 58 62 71 12 13 23 52 62 19 59 52 50 69 53 55 61 59 56 11 56 71 43 67 80 11 58 6 10 51 66 79 62 46 60 19 48 57 60 68 66 14 14 59 20 67 68 9 20 12 67 57 54 58 10 57 72 19 13 18 54 52 56 63
51 55 59 58 69 17 14 56 74 15 72 67 62 66 49 62 67 72 19 56 67 15 63 60 52 64 22 22 65 43 11 48 61 53 55 68 69 19 11 65 58 69 78 22 20 69 59 14 55 17 11 50 66 53 53 63 66 64 57 73 65 55 62 19 66 55 70 47 21 61 16 63 54 42 18 60 71 58 51 55 8 60 60 59 14 22 16 14 65 52 57 13 63 58 60 55 16 49 17 62
52 9 69 15 49 52 50 20 64 51 58 59 73 55 56 79 56 48 64 12 66 10 65 20 21 65 58 54 54 59 72 70 55 47 13 21 15 69 13 55 65 70 48 52 63 47 46 12 47 17 56 59 62 38 49 70 20 55 20 62 56 57 54 46 61 70 47 48 68 12 12 51 61 59 59 72 24 68 58 59 16 75 55 56 78 77 15 51 16 52 61 54 46 69 15 49 63 55 66 55
57 12 53 17 70 55 56 53 62 49 59 78 59 65 10 56 23 60 52 62 69 42 45 53 59 48 66 12 66 63 18 51 59 74 16 63 68 66 51 14 17 72 14 17 67 48 21 50 65 57 48 59 18 53 55 56 21 53 63 59 47 15 61 12 53 45 20 22 47 16 60 61 16 65 53 26 61 80 10 23 17 47 21 47 65 15 53 61 17 62 58 90 46 49 67 55 51 61 19 70
48 44 61 14 65 63 22 17 70 58 41 14 20 55 53 50 58 59 75 51 57 54 55 75 66 48 77 21 57 15 18 13 56 73 50 64 21 63 14 53 16 50 66 17 68 18 60 51 45 71 18 49 52 61 72 15 66 54 58 58 60 17 63 19 14 64 52 67 22 67 50 66 22 62 12 61 55 13 57 66 85 25 12 76 59 49 55 69 22 66 56 81 51 77 72 65 12 55 13 69
41 63 68 74 65 20 24 54 14 13 55 62 41 56 43 18 17 70 56 71 56 61 63 47 56 61 69 16 19 52 71 38 66 14 18 60 16 75 24 56 16 52 62 67 53 64 62 60 12 48 48 48 50 57 18 10 41 15 55 45 62 43 50 48 55 62 44 10 15 9 76 68 14 63 17 73 48 66 13 14 12 14 52 61 64 55 14 67 48 52 13 20 56 60 17 54 23 18 17 21
17 17 71 70 69 68 18 61 68 62 20 54 70 59 67 64 70 75 67 60 10 18 15 67 64 54 69 63 45 13 43 62 46 59 43 54 56 65 68 69 9 59 59 52 76 47 57 62 60 18 61 52 65 16 13 51 12 72 53 52 71 65 18 66 63 60 66 58 45 58 64 51 51 13 56 55 13 16 19 47 57 13 57 20 18 75 50 63 54 65 12 47 53 55 47 60 61 71 18 57
61 56 44 52 12 53 53 54 64 52 15 53 19 48 50 53 45 16 15 16 63 73 54 63 43 53 14 15 6 64 55 65 17 46 71 51 59 41 63 18 55 58 17 51 52 61 80 60 12 51 16 62 64 60 20 77 65 62 71 12 22 22 16 58 64 55 52 18 20 17 13 20 57 20 21 17 18 52 17 8 61 58 8 41 59 61 24 46 60 17 63 9 69 61 57 66 20 20 84 53
73 20 60 57 18 16 43 72 48 17 72 12 65 22 61 54 49 48 54 57 60 58 12 64 65 66 62 21 67 61 51 12 68 50 20 55 60 67 58 59 17 59 18 65 19 66 65 16 16 66 15 62 11 14 65 11 55 15 45 58 9 82 47 13 15 15 50 58 20 18 72 14 69 39 10 45 50 59 16 51 18 44 51 65 39 59 13 53 43 50 49 14 13 59 18 10 60 15 23 10
52 19 63 10 60 65 17 21 46 8 18 50 64 64 49 43 15 58 14 53 64 57 62 60 59 18 10 23 57 61 73 68 11 55 12 21 18 47 45 60 81 54 46 13 54 68 11 66 68 51 57 17 21 57 52 45 58 70 76 57 52 57 55 46 18 14 12 12 68 52 48 80 66 76 60 51 61 67 61 12 62 11 8 70 10 58 91 52 60 57 63 14 17 16 54 44 56 17 51 60
16 10 37 12 46 59 49 58 20 15 11 57 58 84 56 49 59 48 17 48 43 71 64 62 49 16 44 52 53 13 63 55 65 60 68 16 44 57 13 65 65 71 60 13 45 57 61 67 51 74 15 15 22 14 17 54 71 49 15 57 62 56 61 24 19 49 56 55 70 12 65 17 12 18 88 65 48 71 60 64 74 51 56 63 50 58 59 43 57 54 17 68 21 65 59 55 13 66 59 16
13 56 47 64 67 45 68 57 49 52 53 48 47 68 55 58 24 56 67 12 50 53 53 79 47 48 67 55 51 56 21 53 65 81 15 45 18 10 36 74 61 61 71 66 21 55 50 55 65 57 15 14 52 64 24 13 71 19 61 72 12 49 20 13 54 57 57 65 56 52 52 57 53 58 18 19 53 67 67 74 70 19 14 45 59 13 53 24 67 73 41 61 14 65 69 46 53 63 56 63
52 54 66 48 20 14 63 68 40 64 15 61 17 55 10 52 61 38 15 16 56 44 62 50 64 58 18 17 51 85 21 68 48 71 48 79 9 12 17 11 55 60 53 57 52 71 64 63 61 64 15 51 66 50 11 52 60 60 70 20 56 10 15 64 65 17 20 57 58 13 12 54 16 17 59 23 54 66 56 66 64 54 67 61 62 17 66 56 65 12 18 53 59 46 60 54 15 46 58 61
11 8 61 21 19 55 56 16 15 23 63 52 63 59 60 45 13 46 72 18 61 15 74 60 11 17 71 52 71 68 13 54 58 56 56 51 45 60 18 12 70 44 64 66 44 76 65 42 12 77 42 71 15 57 17 55 55 57 18 61 56 16 74 41 44 18 17 76 71 56 71 55 10 55 56 9 73 52 48 54 46 54 13 53 56 59 46 56 65 57 55 67 56 17 70 53 14 86 14 64
14 54 14 46 16 54 51 7 71 59 73 18 57 63 17 73 21 72 55 68 62 53 71 55 66 58 56 26 18 50 11 61 20 50 56 56 62 17 51 60 15 66 65 14 18 63 64 57 65 56 67 60 13 13 55 51 53 52 21 8 45 60 59 12 68 64 44 49 17 11 14 60 45 67 9 40 41 59 77 43 61 59 59 62 63 12 69 13 65 13 59 58 62 15 56 72 16 29 50 48
43 63 53 16 65 17 65 11 66 61 69 17 12 74 15 59 75 60 56 21 51 45 50 66 68 54 12 58 60 14 60 62 16 62 60 66 13 79 49 17 55 13 15 22 17 17 54 59 52 66 56 25 21 80 22 46 19 15 17 73 57 52 24 46 13 64 62 61 45 67 50 50 59 57 14 59 54 54 41 19 18 56 59 61 76 72 68 46 47 48 49 59 64 48 20 65 16 15 16 16
14 45 16 13 45 79 69 60 16 77 7 55 55 75 65 63 67 71 54 19 56 65 60 63 13 72 19 10 60 13 49 60 16 69 17 17 68 61 60 57 47 65 12 60 52 61 53 64 21 18 12 58 67 15 59 16 57 51 62 43 48 49 17 16 63 71 69 45 8 55 46 8 69 56 15 46 64 67 75 18 22 34 65 74 17 57 56 51 46 59 63 15 65 68 55 63 48 12 14 53
58 74 9 17 58 74 58 43 63 13 40 6 54 60 91 20 62 51 51 48 41 58 70 53 58 49 82 66 68 17 73 18 49 44 56 78 24 50 76 62 58 52 74 56 56 62 44 65 29 71 75 17 64 52 57 53 55 43 16 62 54 43 49 60 21 18 50 22 70 65 45 65 51 72 63 18 74 47 66 15 56 17 7 19 14 69 50 66 48 63 75 65 55 57 12 58 49 19 12 60
47 56 54 62 16 59 50 71 70 49 67 50 55 12 19 46 74 47 51 51 17 67 51 65 52 15 54 55 49 55 79 58 67 54 20 61 14 43 58 18 13 56 54 10 11 61 59 48 60 65 62 53 15 14 50 67 8 12 73 19 17 69 67 61 51 14 60 59 61 77 67 9 46 17 19 15 47 46 15 14 18 67 73 52 14 21 14 59 54 68 62 20 63 19 15 49 47 58 64 59
43 15 73 61 66 64 15 16 68 22 64 55 60 68 61 70 60 54 70 84 54 64 66 64 58 63 57 76 59 66 57 11 26 62 73 18 14 51 54 50 20 65 47 62 57 17 40 50 57 46 14 71 65 17 61 73 54 58 15 73 83 56 61 49 53 59 21 47 20 10 20 57 20 65 61 15 20 10 19 49 56 60 68 58 67 51 13 11 17 70 51 54 70 27 54 18 59 20 66 18
56 49 38 65 46 77 62 72 56 22 60 55 57 11 15 16 54 41 67 25 17 17 67 65 65 57 60 16 15 17 60 15 12 23 66 62 53 75 7 80 10 50 58 16 57 11 9 68 53 64 54 20 9 53 61 60 51 54 60 54 13 48 67 61 63 49 55 49 46 77 59 58 63 67 56 51 11 74 53 17 16 53 76 22 65 19 56 54 16 59 66 69 67 59 15 72 54 56 17 18
18 65 68 51 10 47 8 66 57 58 59 19 15 13 14 59 52 20 46 59 70 51 61 65 75 58 14 71 13 18 65 79 59 61 14 44 56 48 50 64 49 17 73 49 65 15 64 46 48 19 72 18 46 51 14 8 47 16 21 58 56 63 10 74 69 61 54 59 51 65 60 70 57 23 66 50 15 17 68 68 15 45 23 46 62 54 15 64 53 78 63 71 57 73 16 52 37 71 62 67
15 53 53 58 60 56 26 16 11 21 13 51 69 64 58 68 19 18 21 54 66 52 56 60 72 14 64 78 48 60 65 62 65 73 66 67 55 61 50 14 52 49 58 14 56 9 68 19 84 18 10 64 60 72 54 13 12 71 42 60 61 44 48 53 53 21 18 13 64 14 40 63 20 13 60 59 63 53 15 69 59 62 52 73 57 61 56 13 57 9 16 71 58 16 68 58 13 66 17 49
22 72 61 48 58 60 61 50 15 9 53 53 48 24 54 67 56 55 64 60 56 26 13 19 18 8 55 17 67 15 60 13 76 55 57 80 77 53 48 60 57 73 57 39 60 60 52 12 48 59 21 53 20 53 51 65 68 69 8 17 9 63 65 16 50 67 50 8 16 7 64 81 65 57 65 19 50 60 62 18 56 69 10 70 68 64 72 17 53 69 68 71 16 53 7 67 46 62 57 54
44 52 16 56 59 65 58 54 11 47 60 16 19 57 39 17 20 69 68 58 53 44 15 62 76 11 13 17 79 74 61 60 24 65 49 74 63 20 59 16 55 68 63 69 16 13 63 62 67 61 20 21 16 58 72 57 72 55 55 14 51 71 13 66 14 70 56 58 56 57 11 51 62 53 65 47 69 60 65 56 50 13 54 47 63 50 38 9 42 17 65 61 57 46 74 67 61 50 53 46
70 57 49 54 59 11 56 78 66 56 55 50 54 15 74 75 49 54 71 69 15 73 51 55 76 16 15 54 68 63 52 60 11 55 42 18 53 54 17 70 70 15 18 60 63 11 15 46 72 64 10 57 62 49 65 14 56 68 45 13 10 53 11 62 55 13 66 12 47 61 55 51 14 56 47 16 46 15 44 15 59 9 61 11 63 7 56 64 57 14 20 67 66 65 19 20 14 61 61 61
63 15 57 54 65 70 10 19 73 17 44 21 60 13 68 14 16 57 13 58 60 17 17 70 14 43 56 43 65 52 54 59 61 15 50 62 10 56 64 64 47 50 64 61 71 69 13 15 52 17 57 12 16 70 57 49 12 58 16 51 67 65 54 22 57 57 66 45 12 20 59 63 49 53 45 18 64 56 61 19 15 24 72 62 56 66 54 43 59 59 74 46 54 52 49 7 51 66 58 45
65 8 65 57 56 60 63 57 59 51 58 62 51 51 69 34 58 56 74 70 54 45 62 64 18 49 84 63 55 16 16 16 21 56 63 46 61 11 50 57 15 63 71 51 52 16 60 61 41 74 18 61 65 10 19 41 55 15 60 57 64 45 16 37 52 56 58 24 47 19 18 49 15 68 51 63 66 51 61 52 66 14 46 66 17 16 59 61 21 49 61 63 16 14 54 20 78 19 66 56
12 29 58 13 55 60 15 52 72 9 19 14 19 51 47 13 56 57 15 40 14 50 73 53 63 55 17 61 22 64 45 67 55 65 12 68 54 75 70 60 64 56 20 19 71 14 57 47 61 53 15 67 11 63 21 10 14 13 68 33 14 17 61 63 13 10 64 59 52 64 45 9 17 52 54 19 11 51 13 72 45 52 62 57 48 73 10 13 57 12 75 53 19 56 78 50 19 38 15 22
