68 55 34 3 54 53 6 58 50 1 70 48 40 61 58 25 46 25 66 58 59 58 27 3 52 57 62 59 34 58 54 58 53 59 52 22 19 60 30 74 58 35 2 3 24 49 2 35 55 1 53 44 6 51 65 50 28 29 25 49 23 5 57 5 32 22 63 69 19 63 64 37 39 28 70 36 31 2 28 31 3 26 58 68 54 48 32 28 65 68 57 25 46 59 3 73 56 64 23 28
2 75 54 63 67 34 1 44 33 59 2 61 31 29 59 33 61 2 2 4 36 3 65 62 31 32 49 35 27 2 63 77 54 38 21 44 22 18 29 17 69 53 3 63 4 30 29 55 34 66 4 26 28 24 50 56 26 39 35 47 50 49 20 53 54 59 3 2 3 22 67 64 38 54 27 3 21 61 3 58 51 33 23 2 6 26 5 22 60 58 29 58 45 66 3 76 31 29 63 1
8 1 68 28 4 57 22 59 2 73 33 22 61 24 29 59 60 22 58 2 23 55 65 1 61 4 28 51 66 57 58 24 1 48 25 68 4 22 58 19 24 29 3 67 57 33 2 23 5 32 2 29 54 54 66 43 31 4 57 59 2 30 69 68 69 26 69 18 56 27 33 54 2 56 28 61 26 63 63 23 24 30 49 37 4 1 48 61 55 58 4 72 75 25 64 3 3 2 64 55
63 61 58 59 62 6 57 75 30 45 23 3 68 55 39 36 25 25 60 19 61 1 26 51 56 60 63 25 65 70 28 23 56 30 26 31 65 51 28 6 29 2 1 29 22 4 5 47 50 59 5 2 62 3 38 47 4 26 60 3 31 52 5 53 62 27 35 44 50 60 57 74 61 61 32 2 0 33 50 54 1 53 59 54 41 55 34 33 63 16 54 62 32 30 51 57 60 58 54 1
28 61 27 32 38 24 45 59 62 33 1 47 59 72 53 58 63 58 56 26 57 25 32 3 20 71 31 57 4 57 68 67 3 6 62 34 30 55 1 3 75 48 61 31 67 30 22 56 65 5 58 55 24 27 1 57 44 20 2 56 29 58 56 50 27 44 63 26 24 47 3 27 30 55 65 40 2 25 46 28 26 66 2 24 54 74 62 50 53 4 18 38 74 28 29 49 21 3 40 65
64 20 23 54 64 24 0 4 1 5 28 55 23 67 31 50 1 67 5 34 4 63 1 68 53 52 15 52 25 4 4 32 1 61 54 25 31 70 31 18 27 64 2 25 25 66 2 52 53 53 32 24 22 73 3 51 1 42 51 45 52 2 69 29 4 49 63 21 67 56 59 23 29 1 60 56 57 53 39 3 2 53 76 33 58 49 51 62 3 33 26 78 42 5 73 56 55 67 34 1
3 56 38 22 37 54 3 49 25 42 44 52 36 64 24 62 1 4 19 68 64 30 66 62 42 71 25 48 30 3 17 58 21 63 32 28 25 70 21 35 60 53 23 30 25 59 30 56 49 36 63 56 42 56 24 29 2 4 62 24 20 59 32 28 48 62 30 50 72 2 1 21 26 37 55 30 63 26 26 54 50 26 57 1 28 2 21 4 62 57 3 39 69 41 57 59 55 49 2 26
1 29 72 63 4 60 37 26 24 53 26 60 61 4 59 9 49 63 29 4 42 54 63 0 25 58 19 28 76 2 57 42 59 68 3 63 4 30 36 59 69 54 64 1 27 30 52 26 63 22 63 46 3 28 23 28 65 72 60 57 70 50 2 3 3 54 4 27 64 0 21 68 2 38 39 55 26 64 72 26 3 5 72 30 25 22 62 59 1 54 63 25 22 46 26 62 27 31 1 62
30 37 54 59 18 31 26 25 38 26 28 54 70 6 68 22 3 27 45 3 27 3 2 59 27 67 3 29 1 26 22 33 52 2 2 47 44 57 3 47 51 23 1 64 24 30 41 28 57 1 19 58 4 55 29 30 62 62 29 49 23 21 24 61 0 3 53 59 5 1 31 49 24 24 58 65 30 67 50 70 2 4 23 64 60 63 62 63 21 3 0 29 76 55 1 21 69 62 51 61
62 59 3 25 45 64 23 64 64 59 42 55 45 61 16 58 66 24 3 58 28 57 6 5 22 59 72 66 3 2 28 52 0 29 29 53 2 3 25 30 25 60 56 3 67 59 28 52 45 51 46 33 75 62 19 4 78 48 68 50 59 49 60 1 65 4 61 24 26 27 32 51 38 65 2 64 62 48 38 57 31 67 26 68 65 29 65 55 29 22 51 50 19 52 29 30 68 1 55 53
31 46 44 57 67 51 25 51 60 29 44 58 30 54 24 32 5 55 2 31 31 56 52 52 1 30 56 52 27 50 61 4 21 58 69 20 72 27 60 61 0 49 31 63 2 64 28 3 31 28 34 2 49 64 47 35 26 20 54 22 25 50 24 51 26 56 50 52 51 24 1 38 33 29 71 61 33 70 63 71 75 2 56 56 22 34 32 3 28 0 46 21 56 63 32 5 66 35 2 19
2 64 56 2 30 36 44 22 28 50 19 47 16 32 58 58 29 3 3 2 67 25 23 54 75 63 55 68 29 3 17 26 60 65 56 61 29 2 35 24 21 60 32 52 58 24 54 57 1 61 64 0 22 54 28 59 2 3 23 21 61 66 26 70 71 36 30 38 46 25 51 61 22 69 63 57 25 52 36 6 5 40 22 28 23 27 26 29 62 55 50 57 22 1 62 26 59 0 61 4
26 57 5 68 57 34 55 30 58 27 61 59 22 56 55 30 29 48 62 20 30 21 2 3 24 29 33 57 1 29 19 21 61 49 1 57 27 41 1 55 64 7 22 32 23 26 34 72 68 2 55 46 2 2 24 50 28 32 30 2 27 5 27 63 58 26 45 56 38 55 24 50 30 29 1 5 58 32 25 33 45 7 61 68 62 53 20 55 22 66 55 56 6 54 4 23 4 54 70 27
25 64 62 54 27 51 59 56 45 23 65 61 27 69 52 20 30 30 67 58 26 19 70 53 4 65 4 40 56 17 14 61 57 2 7 51 61 54 57 23 60 32 61 28 59 30 55 32 26 27 33 2 26 27 30 61 56 38 26 65 4 1 25 3 1 24 34 8 54 27 34 77 55 24 70 70 26 48 68 49 50 54 52 62 72 29 50 58 56 29 1 4 26 3 64 70 55 63 52 60
52 29 19 57 70 32 50 34 25 4 24 66 22 16 26 58 40 51 56 26 48 55 59 28 56 3 31 62 60 31 3 23 29 32 58 1 54 53 7 63 27 64 64 32 27 61 4 3 72 66 76 69 65 61 7 1 49 23 19 58 52 35 27 27 57 2 23 28 28 61 49 32 62 50 31 33 2 63 62 49 24 63 31 57 5 36 71 27 52 53 77 1 60 56 31 47 2 50 26 45
21 57 62 24 2 4 62 27 23 27 73 32 57 79 56 18 61 1 67 51 1 62 24 63 59 1 21 39 59 59 60 58 28 18 80 24 52 2 62 34 61 60 35 57 71 65 50 50 48 73 30 3 51 34 30 72 39 55 45 2 30 35 75 64 24 52 56 39 27 68 2 56 23 2 54 32 28 18 55 65 3 54 67 31 21 53 38 27 52 25 63 60 59 19 30 30 1 30 2 54
24 1 21 56 32 1 23 60 32 26 52 66 44 1 24 63 18 55 26 2 23 26 23 68 72 27 53 66 28 3 62 59 52 2 51 61 43 66 67 34 24 54 56 4 65 61 59 65 52 33 3 0 50 60 28 25 30 59 32 26 55 32 0 65 64 79 25 65 21 51 46 54 29 6 62 3 20 27 1 27 54 20 57 1 1 5 60 1 26 48 59 57 33 63 20 56 2 49 1 30
64 1 27 29 4 68 23 3 57 66 6 22 65 1 60 3 5 70 0 22 29 28 47 1 31 70 53 61 70 63 61 58 0 31 60 72 35 67 63 22 3 51 56 32 68 62 64 0 4 52 65 24 69 34 26 31 61 58 26 28 83 20 36 35 72 65 22 46 2 52 53 56 24 2 39 59 13 61 49 28 0 70 58 27 29 60 53 58 50 62 27 57 24 3 3 75 58 23 56 2
3 4 26 3 48 50 35 18 55 30 27 45 4 59 71 54 53 28 22 73 32 38 4 32 58 2 30 59 72 36 25 5 26 2 71 26 18 32 25 4 50 31 59 57 67 2 61 28 62 3 50 56 25 4 26 65 67 29 32 59 51 80 58 56 2 62 27 55 38 64 2 63 58 47 51 62 30 28 34 20 3 19 19 2 21 3 1 24 30 29 26 50 55 48 51 49 2 30 27 62
28 56 16 54 23 33 5 55 59 25 19 21 20 59 53 4 17 28 54 67 33 21 30 64 3 63 50 49 32 64 2 29 28 31 3 65 2 0 75 26 28 63 62 34 63 1 58 33 65 4 71 77 2 20 63 34 66 45 23 1 3 52 52 3 60 64 25 53 56 51 17 25 59 46 64 1 35 4 25 41 32 68 58 23 55 61 69 80 53 4 1 50 44 58 75 61 60 62 1 65
60 69 18 22 58 68 63 56 56 51 2 56 71 30 69 27 55 64 61 19 52 69 51 28 30 3 23 25 30 55 1 51 26 51 44 60 7 1 5 6 22 62 2 34 60 45 49 53 25 58 29 63 57 69 14 27 29 50 2 29 0 33 22 47 55 61 66 59 42 63 59 54 83 33 6 58 3 23 18 53 59 29 56 24 33 54 29 3 2 70 65 52 34 22 1 16 73 51 41 59
50 23 62 65 5 25 1 60 60 22 18 22 54 20 26 26 2 54 26 20 26 43 29 7 69 67 46 56 19 1 39 25 58 64 56 2 71 24 62 18 17 48 48 57 61 26 2 60 21 35 27 34 53 64 28 63 23 3 31 56 62 27 30 57 35 53 51 29 47 52 27 67 57 26 27 26 2 52 60 26 55 16 53 31 3 32 49 70 71 54 26 80 32 2 42 53 56 51 26 32
64 64 4 53 61 28 57 5 59 62 0 6 60 26 32 19 2 25 53 28 54 62 31 26 69 28 1 2 66 39 68 3 48 67 38 54 1 62 28 51 28 31 53 62 59 23 33 56 37 2 2 24 58 31 2 58 54 52 58 51 58 59 41 66 3 64 0 16 2 55 3 50 60 29 23 60 19 34 28 21 60 29 64 59 19 28 59 61 45 67 34 0 48 47 36 21 53 68 46 62
24 50 2 27 2 21 24 28 0 62 32 69 54 3 26 62 56 64 36 52 4 48 18 57 26 67 1 33 28 54 79 63 56 59 61 28 54 73 36 6 27 25 45 33 58 35 24 32 68 52 51 61 26 2 36 36 24 59 29 55 63 49 3 26 20 25 23 47 4 62 25 24 49 57 69 47 29 40 59 56 3 65 30 35 53 25 6 24 23 20 64 56 1 54 53 66 62 32 4 3
57 63 61 64 37 50 25 28 23 58 49 31 75 31 54 66 65 67 55 59 62 27 34 25 21 41 56 55 54 21 45 66 66 34 61 87 1 33 2 5 27 2 35 60 47 25 65 34 54 32 4 29 28 61 25 32 51 4 23 4 3 1 58 36 24 3 3 47 24 53 65 26 53 42 52 61 21 28 54 25 59 25 37 3 29 29 61 1 55 29 36 34 26 23 27 46 31 25 18 56
63 4 38 74 66 26 1 64 65 58 53 28 60 55 37 25 27 21 56 46 37 48 55 61 50 51 2 56 0 63 47 18 30 72 19 63 33 29 37 37 56 19 64 26 26 51 55 65 59 53 2 3 23 61 28 2 48 6 53 22 53 36 26 25 64 4 47 6 66 63 23 2 55 6 61 59 50 32 32 56 47 2 31 28 53 4 1 74 59 32 50 3 68 60 47 3 35 26 3 54
65 28 4 1 47 61 62 52 31 29 46 17 24 24 23 2 47 68 50 16 61 56 27 53 51 2 47 66 72 53 26 56 67 62 2 28 63 26 3 35 29 2 28 83 2 61 2 2 39 58 43 0 26 23 65 53 21 46 40 57 3 51 0 27 47 2 51 28 28 23 60 35 27 34 6 51 63 0 24 55 68 7 29 38 45 52 63 49 24 53 63 22 57 23 20 27 1 57 2 47
60 1 1 61 25 62 4 56 62 19 2 73 57 27 60 29 64 57 49 47 58 2 33 0 67 20 65 64 27 54 24 36 19 23 22 57 35 70 74 63 1 35 21 47 61 29 26 66 49 31 47 2 68 37 50 27 81 18 65 54 28 42 57 44 54 58 26 64 24 51 62 56 28 23 21 25 30 28 2 0 46 46 60 22 3 28 49 27 48 63 71 28 59 36 55 56 54 18 62 57
23 65 1 57 20 22 59 62 27 23 5 2 24 66 33 27 4 22 51 28 33 56 6 4 31 32 66 63 19 65 57 45 64 56 66 29 20 1 44 61 52 24 65 3 58 69 59 25 26 20 49 59 55 38 60 1 61 31 62 74 27 34 2 26 25 76 71 57 35 48 24 36 21 64 2 46 3 61 2 1 29 68 62 65 73 21 50 59 55 50 32 72 54 35 46 32 35 65 58 53
35 1 14 64 24 4 25 1 26 24 22 58 65 61 46 68 59 26 60 69 58 5 61 44 53 2 72 26 74 2 71 53 35 65 61 25 61 62 43 25 63 69 66 4 55 55 67 48 2 26 59 24 18 66 24 59 48 19 33 32 0 28 1 30 23 26 47 16 64 32 49 24 47 51 6 45 66 19 62 26 71 20 39 4 54 62 53 76 50 59 27 22 3 52 21 19 30 62 32 61
59 58 28 1 63 51 46 6 2 27 60 57 58 1 56 55 65 28 54 57 18 24 23 20 54 26 24 30 56 70 54 64 67 52 46 70 2 49 3 33 52 68 30 70 31 35 26 3 68 53 50 17 62 48 22 65 41 46 63 3 71 18 52 27 40 57 0 1 55 57 63 1 61 0 47 25 29 26 35 47 53 55 0 36 33 34 55 63 27 35 62 31 28 59 58 26 46 21 21 24
18 68 3 3 76 34 65 60 28 2 34 30 64 53 27 54 56 33 45 24 33 59 33 25 50 59 6 27 53 30 53 21 49 37 71 25 33 66 27 27 1 61 63 3 53 45 2 65 25 23 59 23 2 54 26 26 63 32 42 76 55 1 28 24 28 1 60 66 66 51 27 54 30 51 23 56 66 70 23 32 26 53 68 4 3 65 57 37 5 63 2 69 62 56 53 61 27 71 4 23
57 48 58 25 53 33 2 53 62 63 33 73 4 25 28 28 5 30 27 35 29 29 1 56 37 42 24 20 66 28 3 72 33 29 55 29 27 58 30 21 63 3 26 24 71 3 61 62 1 56 58 34 61 3 57 52 49 61 36 62 2 20 4 49 30 69 29 56 54 24 2 34 53 59 16 22 14 59 33 52 2 54 30 44 64 69 26 61 32 61 56 26 49 57 53 32 49 51 46 49
31 37 2 26 70 54 73 26 3 43 57 58 21 28 61 7 43 56 67 63 46 57 64 45 30 64 65 50 27 22 72 55 72 3 60 4 50 42 32 58 65 53 40 4 5 60 56 45 1 57 55 63 55 2 49 46 60 42 64 26 3 24 2 2 28 59 63 24 70 53 66 63 75 3 29 19 27 31 50 34 54 23 26 73 60 2 67 61 30 2 57 33 58 3 31 28 4 20 44 28
60 50 23 67 73 4 56 37 26 53 3 2 19 29 42 14 25 0 59 53 56 28 33 24 56 49 26 6 60 64 26 59 26 30 57 31 34 3 24 67 22 53 27 2 58 22 23 5 56 58 58 61 28 61 2 55 84 65 62 4 57 2 3 27 44 3 36 29 6 32 57 59 67 48 16 71 61 50 56 22 34 62 67 55 64 4 58 46 57 48 24 0 50 24 29 1 23 41 27 23
74 25 25 7 2 53 19 54 3 30 47 61 2 33 52 46 53 50 32 64 29 45 20 3 22 32 74 50 73 58 2 61 22 28 53 57 36 3 5 48 66 73 49 2 53 24 67 3 33 30 54 64 25 25 28 59 28 64 25 2 3 27 53 5 28 2 49 49 37 29 65 53 25 1 25 66 19 73 30 24 51 21 2 61 0 0 29 32 62 1 51 22 71 49 78 49 26 4 4 17
25 18 58 23 26 62 68 38 45 26 55 21 31 25 63 26 35 50 6 70 63 52 56 61 30 43 64 64 54 55 52 59 63 1 79 25 48 69 24 52 70 24 59 55 26 2 57 55 52 22 2 79 73 22 3 63 40 54 52 68 20 55 31 63 2 57 47 0 49 26 61 61 38 54 63 28 58 25 26 54 27 56 38 49 0 45 25 66 51 72 42 3 7 56 63 57 19 62 3 30
77 64 44 30 3 25 55 72 0 5 59 29 71 45 59 36 49 56 26 3 68 51 24 49 53 60 61 61 37 37 50 4 28 51 69 65 45 1 47 57 22 51 51 54 19 30 29 61 1 43 38 19 25 59 65 63 18 5 1 31 50 32 28 27 0 63 54 54 55 1 42 57 66 51 38 46 67 67 62 25 59 29 53 30 19 22 64 2 26 57 29 4 63 50 28 25 0 24 35 4
24 57 62 3 59 26 22 70 69 3 56 31 27 52 53 30 58 51 48 27 60 64 60 63 50 29 52 32 50 38 22 30 60 28 55 49 2 23 56 59 26 67 26 60 61 58 53 52 2 58 26 5 31 0 51 54 31 60 3 21 43 59 62 26 52 43 2 27 65 21 5 27 2 63 60 3 31 60 57 62 29 1 52 33 28 22 36 25 26 23 4 60 5 29 16 64 54 59 70 22
61 66 53 61 55 22 65 29 52 1 4 3 42 69 27 23 2 24 4 32 57 25 58 57 2 1 68 43 1 51 31 19 33 67 4 55 23 26 55 66 23 22 56 26 60 40 17 55 29 61 6 4 22 0 46 29 68 52 3 48 4 44 19 42 1 65 31 64 26 52 1 68 23 27 26 1 6 58 44 28 19 36 24 18 44 62 26 56 38 74 53 22 59 21 29 3 75 42 29 29
3 62 52 35 22 23 60 50 57 22 34 58 25 39 55 27 2 29 46 33 32 57 60 29 58 35 32 60 3 25 57 32 49 50 28 31 56 66 62 75 55 27 52 69 33 23 20 63 33 56 59 1 61 3 44 58 58 61 31 63 53 29 42 4 66 33 28 49 69 56 27 23 51 64 51 39 3 18 61 26 51 59 54 58 1 50 51 30 58 45 28 26 58 5 1 52 43 29 73 29
28 43 62 48 24 28 66 29 2 23 58 24 62 4 38 22 60 52 56 36 32 31 51 27 22 49 4 20 1 48 60 40 20 32 65 25 59 60 4 52 56 24 55 3 5 26 62 1 2 20 17 26 60 80 26 1 0 56 36 36 51 27 59 23 26 28 64 54 66 1 72 3 35 50 19 55 3 25 31 63 53 55 3 53 3 66 29 57 26 1 1 26 5 74 66 57 62 60 26 31
55 48 48 59 32 60 33 20 27 62 54 71 24 25 38 3 57 28 23 54 48 3 57 38 30 67 25 5 55 30 58 2 29 31 55 56 0 64 1 65 2 74 0 25 1 61 4 23 47 56 3 50 58 5 3 35 60 59 2 69 29 63 1 47 28 70 25 28 59 45 36 50 5 48 63 60 59 49 56 19 60 21 2 54 52 42 4 48 60 58 0 46 54 58 48 53 59 31 67 5
58 1 21 35 29 53 61 50 2 65 2 56 49 0 3 54 3 31 58 30 56 62 50 67 2 60 57 62 61 4 25 36 30 67 26 60 53 21 60 1 52 22 1 22 21 62 59 29 74 23 2 58 53 26 45 72 2 49 66 32 19 4 24 59 25 49 4 59 47 25 63 69 32 20 71 72 20 48 47 63 66 58 58 4 23 2 19 39 59 0 77 22 56 25 35 2 29 22 3 30
18 25 71 62 28 34 54 20 61 54 27 51 28 17 3 32 54 29 28 35 36 3 77 52 49 21 29 84 31 66 55 65 26 1 23 25 60 3 32 51 20 22 49 23 56 62 52 26 3 71 59 61 4 85 69 29 59 30 71 57 28 59 1 24 28 24 35 41 6 1 48 56 60 30 24 3 28 69 66 29 22 40 57 52 22 44 56 21 26 57 37 34 6 64 32 47 33 62 57 3
18 66 6 54 0 22 23 2 55 49 53 34 60 63 19 20 28 4 47 57 63 10 61 54 51 32 55 4 63 34 59 49 64 65 59 58 30 49 36 7 55 26 66 61 55 62 48 31 25 3 68 64 22 51 23 33 5 27 3 1 32 70 4 21 3 52 65 54 24 76 26 56 28 27 25 23 17 29 29 52 55 36 72 19 24 25 35 3 21 24 55 32 55 23 73 43 56 3 28 64
22 89 33 2 24 24 25 62 58 47 58 10 30 17 4 23 57 53 65 61 66 2 31 63 24 60 28 54 66 30 18 29 66 64 56 48 67 18 31 33 59 29 66 37 5 4 26 53 50 65 54 3 54 20 22 24 68 74 1 51 44 4 26 55 31 63 45 24 2 55 27 71 55 64 58 28 70 23 49 1 52 73 24 69 50 61 67 46 58 53 49 49 59 64 28 59 58 60 59 2
29 47 61 1 37 62 20 30 68 51 53 61 66 25 25 22 36 51 68 60 55 34 66 32 67 0 48 51 24 55 57 26 45 34 52 45 0 57 61 56 54 51 34 23 21 1 1 30 45 25 65 56 53 48 29 65 48 52 76 50 57 32 1 5 43 22 52 27 74 56 50 55 59 57 49 30 28 27 58 35 53 29 60 55 33 36 2 49 60 18 35 27 3 1 1 26 64 55 34 63
4 57 37 59 67 47 52 2 61 48 31 53 26 53 54 20 55 1 20 63 68 79 60 61 54 22 26 29 34 49 54 71 56 34 58 25 28 65 44 61 31 25 29 55 59 50 21 1 1 3 27 2 32 36 18 48 61 61 53 58 21 70 25 37 30 73 51 28 60 72 1 70 57 26 5 1 0 48 53 52 2 32 7 46 55 4 61 39 20 42 1 3 58 72 3 53 24 63 55 25
28 42 54 59 56 56 53 3 62 4 22 33 54 72 25 28 45 62 67 59 59 67 58 49 25 28 31 24 3 56 31 61 57 32 56 65 26 29 23 60 49 15 59 49 30 4 64 61 22 44 33 67 19 55 44 46 2 21 26 26 2 51 63 91 42 71 5 33 44 82 5 21 25 28 70 35 50 69 21 61 30 67 3 3 69 20 3 47 8 62 1 0 3 49 72 14 54 51 2 26
56 27 0 61 30 69 21 52 5 51 46 57 33 47 32 66 1 0 66 74 59 35 57 64 26 35 1 59 54 54 74 28 25 49 31 54 2 3 66 31 59 2 60 20 23 30 64 33 0 31 21 24 51 60 2 3 71 5 60 35 5 29 32 18 72 23 46 61 28 4 66 25 27 5 7 20 24 60 29 63 58 25 28 3 23 65 4 62 3 4 67 30 25 22 28 31 33 76 24 25
26 68 27 41 29 55 23 55 68 30 27 23 34 61 59 29 53 27 58 69 64 61 61 18 30 56 39 44 64 23 62 54 22 52 58 59 27 60 61 2 59 32 61 27 46 32 54 64 24 62 53 16 16 61 30 64 58 2 4 64 68 2 27 2 3 62 77 22 43 54 30 46 27 65 19 5 70 56 30 28 61 30 61 57 56 32 61 22 63 61 4 61 2 25 45 65 66 1 56 63
2 2 53 27 43 31 30 52 24 60 23 4 2 49 29 27 3 27 35 2 24 55 82 19 28 63 29 28 56 20 61 6 34 61 30 65 24 3 48 27 64 56 49 64 50 54 22 30 62 30 29 61 3 1 64 59 27 2 25 76 23 26 33 25 64 26 3 29 4 54 33 0 24 23 51 20 25 25 65 55 1 27 31 3 48 23 72 28 26 4 32 66 58 57 57 54 25 4 51 22
49 59 2 1 24 61 1 64 28 26 45 54 2 38 7 59 59 20 2 53 61 36 68 33 3 32 3 4 24 27 20 35 58 61 29 27 60 22 33 1 32 34 57 32 59 63 29 68 47 19 58 3 69 69 74 2 55 56 46 20 28 34 57 47 3 54 54 25 29 30 25 36 67 48 2 22 20 30 65 38 57 55 29 48 54 61 33 62 57 57 17 19 52 15 57 22 23 26 46 56
69 2 27 28 37 33 77 2 65 26 2 33 28 54 68 14 26 29 30 34 50 1 67 57 48 5 60 32 2 69 29 18 27 60 32 4 28 29 64 3 58 3 75 0 2 56 27 33 52 26 65 26 51 26 27 33 64 57 44 1 64 34 34 48 46 30 61 52 60 26 3 1 59 32 26 30 58 63 26 55 24 66 31 64 73 3 58 26 42 45 65 28 28 41 27 52 59 33 69 49
25 30 58 51 22 28 59 39 2 61 4 61 24 70 45 21 4 73 69 58 55 28 31 2 68 1 54 4 42 69 2 52 72 69 58 67 25 57 62 60 26 71 65 56 2 26 28 22 3 52 25 51 44 48 25 22 60 52 42 6 2 49 46 2 20 62 42 77 30 20 54 58 47 27 2 63 59 39 20 33 62 61 54 3 29 26 29 5 27 45 26 26 2 49 2 24 20 75 54 31
59 34 64 49 56 32 5 37 40 65 46 7 0 3 66 0 20 17 6 22 58 24 49 46 25 55 26 21 28 31 50 2 32 63 30 5 25 55 51 74 72 68 62 33 57 57 29 75 70 64 50 55 54 25 58 1 55 24 49 34 54 1 66 29 40 58 56 2 25 44 21 12 38 1 3 56 53 3 19 2 52 71 25 61 35 58 58 61 26 1 2 32 23 53 30 60 21 18 51 44
26 34 33 32 4 28 53 19 65 51 27 54 35 44 32 18 25 55 52 25 19 68 24 27 29 43 58 26 5 66 27 4 4 32 18 24 69 2 26 26 63 53 65 62 44 2 39 58 51 80 57 22 33 75 24 47 52 61 33 74 69 39 31 57 28 62 2 31 47 31 47 32 7 47 58 28 64 23 42 55 44 75 28 32 30 61 42 57 54 53 2 55 54 57 63 57 33 26 46 1
28 20 73 34 18 36 61 71 22 46 2 63 23 29 57 58 62 57 21 19 17 30 56 56 53 24 51 3 4 56 6 44 43 60 3 59 48 62 49 68 27 4 64 47 42 73 48 32 3 61 1 3 3 54 54 3 4 34 28 2 56 26 56 65 57 4 22 58 5 58 67 21 56 54 69 62 2 42 59 2 31 53 27 25 62 3 32 55 40 62 36 54 28 5 55 51 57 20 53 52
4 3 3 1 72 67 26 23 51 19 54 26 58 45 22 61 63 24 22 3 61 5 5 51 69 51 59 48 66 63 75 23 47 47 3 18 5 30 65 31 66 28 46 2 27 54 47 52 56 77 3 57 24 61 29 58 54 23 22 29 49 57 31 28 70 3 26 21 29 4 32 54 57 25 24 59 0 59 30 63 30 24 4 71 54 1 53 25 28 22 55 73 26 45 56 47 63 34 57 55
50 54 3 4 29 4 65 23 30 57 67 37 54 63 68 52 58 66 26 30 62 3 52 53 23 48 36 3 40 56 46 22 2 28 23 68 23 55 34 22 68 65 51 65 53 0 23 49 61 52 15 54 72 26 42 57 4 0 66 61 64 48 4 21 4 55 2 50 3 21 37 4 58 2 48 45 49 22 61 32 41 66 51 2 74 48 28 63 59 27 32 51 37 54 65 63 57 57 16 28
1 29 23 64 26 54 33 64 2 25 50 64 16 19 55 55 2 28 3 71 47 65 62 67 44 47 46 23 1 70 31 57 59 2 65 28 1 19 3 60 4 13 1 54 72 33 49 24 54 31 32 31 62 29 67 47 32 4 56 48 20 45 55 49 67 51 68 65 61 30 58 5 50 3 2 34 20 4 29 3 26 0 20 55 65 34 53 34 44 22 3 23 63 21 37 62 2 46 68 29
58 49 28 26 59 68 0 31 32 24 61 5 27 63 56 54 61 29 50 3 21 53 64 19 59 71 32 27 3 64 24 52 78 54 58 4 3 70 25 55 42 19 1 27 3 40 30 52 48 18 63 64 2 2 62 50 4 62 27 16 6 68 44 58 57 50 24 54 23 45 28 52 52 58 60 4 53 22 27 27 75 43 51 2 53 62 55 52 26 49 63 0 1 3 55 29 20 29 21 21
31 2 64 21 72 25 61 34 55 25 64 28 48 22 2 18 29 56 3 29 45 60 49 34 57 73 1 44 1 25 20 60 53 56 60 3 30 60 1 26 82 68 68 50 29 29 24 32 57 69 73 38 53 25 61 24 69 1 28 63 63 4 68 3 2 68 22 3 59 51 3 56 56 26 22 38 5 59 65 65 28 2 65 56 51 53 70 62 27 33 23 24 28 46 57 63 7 47 59 24
0 56 50 50 64 57 59 41 2 58 67 74 27 28 54 23 45 54 26 26 60 56 4 51 63 59 1 55 60 2 32 52 57 61 66 31 20 20 18 0 50 30 30 53 3 25 58 49 72 58 33 29 72 70 50 53 40 56 29 5 60 38 73 32 75 28 46 55 1 60 13 39 2 5 62 62 27 60 3 16 71 29 60 27 24 39 35 31 37 20 50 57 58 67 56 56 22 71 61 56
0 2 58 61 5 42 66 22 3 20 64 27 31 36 36 19 29 1 69 53 67 29 5 55 63 72 25 4 22 42 28 29 6 1 73 75 53 73 23 62 31 53 2 29 25 23 52 54 23 51 19 22 74 1 51 68 56 2 53 28 61 16 69 51 56 49 31 32 29 1 2 7 20 5 24 62 56 49 28 44 48 31 4 64 57 70 32 62 34 52 57 54 53 3 68 3 22 22 51 1
30 68 30 29 47 2 54 2 68 57 80 15 5 29 63 67 3 25 1 56 32 3 47 6 54 20 57 27 55 23 24 61 67 49 30 64 32 3 29 36 63 30 25 48 36 34 26 7 67 30 50 29 60 66 26 57 55 65 35 32 3 54 61 28 2 54 59 2 24 32 58 2 60 71 53 52 22 46 63 20 62 4 72 2 33 5 50 72 22 63 71 76 36 30 59 32 36 18 3 3
2 22 29 52 40 30 41 76 26 24 25 47 29 28 51 63 40 29 58 55 33 49 57 36 19 4 67 56 51 22 21 47 32 51 52 27 22 48 1 58 23 5 61 61 62 52 6 60 67 50 21 63 32 58 67 1 60 60 2 57 53 24 63 62 25 55 42 15 27 3 3 57 74 56 26 4 53 47 3 64 54 50 26 20 22 41 69 66 66 3 1 2 29 22 46 26 51 44 25 66
21 37 62 25 42 24 26 59 36 45 58 29 27 20 63 3 66 65 28 29 60 46 47 48 35 25 56 7 57 1 60 41 60 59 64 29 7 61 29 3 73 22 4 3 58 29 58 21 54 21 2 52 1 2 70 25 24 18 32 62 27 52 59 62 65 24 53 37 28 4 3 51 56 3 60 70 32 27 66 67 53 55 2 67 29 60 0 2 27 71 52 28 42 60 22 31 31 1 2 2
52 21 39 19 25 19 61 56 2 37 25 1 72 4 63 23 60 28 24 2 28 63 26 63 4 55 59 0 26 34 53 53 62 53 17 58 74 52 52 58 4 70 22 53 3 2 5 60 62 3 32 73 53 2 25 62 27 67 51 55 50 33 27 29 29 25 55 33 0 53 32 40 4 3 53 59 75 69 63 53 34 50 26 34 24 57 27 54 63 44 61 25 2 2 53 3 5 36 26 60
31 47 35 24 47 60 17 26 43 21 28 13 25 2 3 26 26 4 69 31 28 3 70 54 23 65 30 15 53 64 76 78 59 25 25 52 5 38 29 81 3 72 58 53 55 37 55 34 4 51 32 50 31 0 4 39 22 21 21 26 26 67 46 44 20 68 17 55 19 35 36 29 30 29 62 2 1 37 2 72 27 53 32 21 34 29 54 70 16 59 1 48 25 58 20 1 50 57 46 67
56 22 51 36 66 53 30 72 61 32 23 1 63 65 69 31 39 27 6 25 65 68 55 4 61 27 75 52 58 7 52 68 6 27 66 52 59 22 26 2 67 59 55 22 30 63 21 26 31 2 24 22 2 27 23 52 31 3 42 53 3 67 30 65 47 32 17 3 56 26 24 67 25 32 47 7 49 60 55 25 60 22 65 57 63 64 4 36 25 25 57 78 2 60 54 64 21 46 38 46
74 25 32 43 3 58 53 30 3 50 3 23 2 5 70 2 50 24 55 18 30 60 64 2 29 52 56 51 2 18 65 59 4 21 26 2 28 42 62 19 26 55 0 56 59 56 40 58 35 57 65 60 3 2 60 21 1 58 62 1 4 37 27 52 3 23 1 60 61 71 66 52 25 52 47 28 2 4 66 22 58 18 22 24 58 68 53 74 27 25 4 72 56 69 26 42 64 40 57 28
28 59 4 68 18 51 61 56 26 52 23 3 1 46 56 35 56 23 58 52 57 65 0 50 82 49 22 21 31 1 2 58 23 52 60 57 64 27 64 20 24 59 69 16 4 25 58 66 38 40 30 24 36 29 15 42 47 52 50 29 3 62 63 61 26 2 24 23 64 64 47 26 29 58 2 46 58 45 68 27 45 2 31 28 5 1 58 30 56 63 4 35 22 24 61 54 35 55 28 30
25 64 51 62 56 19 32 36 54 59 21 4 26 32 61 20 43 57 21 5 23 66 52 56 25 44 4 47 23 56 56 63 20 55 60 52 63 3 28 52 65 49 61 66 4 35 70 15 22 43 50 28 56 50 27 59 57 61 45 48 33 48 54 57 5 32 59 61 55 58 50 2 63 34 67 52 3 2 62 72 64 20 69 63 66 72 28 23 61 48 52 2 20 32 2 51 33 3 55 4
56 22 5 67 4 47 57 57 0 25 20 60 58 29 30 31 29 29 1 31 49 54 64 31 0 2 1 47 28 55 68 48 40 49 1 6 65 2 57 37 50 47 39 58 3 44 29 56 24 0 50 36 41 3 3 78 34 33 24 55 2 66 38 66 71 50 24 26 63 22 41 60 53 0 64 30 62 55 45 1 1 59 53 2 50 27 60 25 76 19 21 2 71 4 0 4 39 60 61 1
33 3 32 1 3 59 66 71 68 54 69 51 62 23 25 69 65 3 47 1 7 34 28 37 20 25 2 59 59 55 9 32 27 75 59 2 75 45 68 17 67 0 53 5 57 7 41 55 57 24 24 50 21 29 58 62 32 65 23 52 30 36 80 33 59 58 29 47 69 67 6 67 61 2 64 4 23 8 52 68 45 64 32 62 3 38 62 38 63 31 59 77 4 43 59 54 69 70 61 66
47 67 0 26 65 24 56 26 0 52 57 25 2 45 27 47 29 2 6 24 68 56 51 25 32 23 61 23 69 65 31 52 31 24 52 22 23 4 2 1 59 3 28 25 62 24 61 57 3 47 24 55 32 59 67 50 72 6 31 31 24 59 59 35 53 19 51 27 25 55 1 34 39 61 29 3 61 68 51 23 4 66 1 55 61 26 23 35 30 5 52 31 30 32 31 59 35 3 54 23
26 48 17 31 55 29 3 62 26 24 74 20 61 20 31 66 31 55 50 66 34 3 31 49 72 38 71 59 68 59 62 50 48 67 55 34 32 30 62 59 29 22 63 32 31 28 56 4 55 24 69 34 18 27 58 50 25 7 2 46 66 76 61 25 1 55 21 69 70 53 66 59 27 61 57 44 59 19 63 59 2 27 63 50 28 35 63 29 28 41 1 55 47 48 25 1 51 56 3 40
0 54 3 31 62 60 65 1 36 72 33 58 5 65 1 20 60 37 21 28 29 55 63 58 2 3 26 49 57 31 57 69 24 30 64 26 1 2 3 45 58 55 50 35 48 0 5 64 63 15 63 54 56 63 52 52 69 49 66 26 81 2 51 50 60 44 33 32 41 52 1 53 2 33 51 18 36 52 58 28 65 67 44 4 26 21 61 1 21 33 54 54 47 2 57 56 25 67 53 72
36 71 9 66 58 25 50 92 28 53 64 27 27 8 29 66 55 18 65 26 27 34 2 3 30 45 54 43 26 33 33 51 59 31 70 54 60 62 26 50 3 27 35 54 23 4 62 60 30 62 48 52 62 52 57 26 34 1 56 30 23 31 25 20 59 46 56 59 1 49 27 7 56 27 32 25 27 59 37 61 45 45 51 29 50 17 3 27 1 32 6 62 62 77 62 31 63 58 24 51
46 52 33 58 25 29 26 31 55 67 63 2 24 70 25 73 40 37 55 30 59 31 35 25 32 56 27 41 21 51 3 28 19 3 51 63 23 30 49 23 33 29 64 57 24 31 30 4 27 3 58 67 56 58 60 71 22 1 57 32 43 53 2 65 59 28 50 27 1 67 5 75 59 65 2 20 20 2 26 57 4 30 33 30 19 52 22 44 44 27 65 30 55 45 26 23 67 1 19 55
55 25 26 3 16 38 18 54 31 32 49 27 64 62 19 42 58 31 27 41 2 23 70 1 21 23 58 28 2 1 53 33 27 3 71 34 63 67 27 2 59 32 55 28 71 31 27 41 24 57 70 56 24 5 47 71 4 69 37 4 64 28 73 72 29 1 52 22 26 57 64 33 53 27 55 56 29 3 34 2 0 68 58 0 22 62 14 51 3 0 24 63 52 0 3 47 46 2 20 30
64 34 3 23 49 60 29 3 24 5 71 1 67 27 44 30 52 63 60 44 26 51 67 23 27 28 59 58 55 3 62 53 66 24 60 2 52 56 61 61 3 2 46 66 28 2 25 56 25 28 59 25 3 21 62 25 20 25 1 59 38 45 44 5 27 61 64 27 4 48 66 30 66 56 69 57 29 2 50 4 57 48 2 62 33 63 28 22 2 53 64 25 63 25 49 34 47 60 1 32
49 44 49 54 58 34 28 58 59 52 22 23 0 3 52 27 70 60 5 57 26 71 21 15 57 53 29 24 52 56 65 34 30 33 1 26 57 29 65 52 1 34 58 26 25 0 44 63 48 2 37 2 66 24 66 37 19 21 55 27 59 63 1 72 65 55 76 58 61 2 33 25 52 63 24 47 4 29 32 32 52 25 50 3 18 38 28 65 0 4 27 22 1 58 19 25 63 4 61 4
48 26 71 35 54 27 26 54 4 31 20 66 64 3 59 2 55 25 39 46 26 56 21 41 3 66 30 46 50 53 49 23 59 26 48 25 53 59 67 19 39 21 57 46 61 27 3 20 27 63 34 3 54 42 31 19 61 55 72 58 18 26 29 57 1 60 22 26 63 58 61 45 28 39 60 62 62 22 52 23 33 29 22 24 31 53 28 68 2 57 6 24 25 62 23 1 65 57 30 48
67 2 28 43 3 68 27 50 20 30 43 66 62 4 59 3 3 59 21 54 49 16 22 31 2 57 60 59 20 51 33 22 64 31 3 1 69 60 25 52 54 50 50 55 64 35 28 55 25 62 28 59 53 7 63 59 53 70 60 45 34 17 72 72 61 5 22 27 27 2 57 16 47 23 48 2 71 26 33 53 62 28 31 56 3 5 4 46 75 30 70 30 1 44 46 21 76 53 49 53
55 18 40 60 74 56 2 29 49 25 65 51 28 2 23 33 44 4 35 55 44 55 27 27 52 52 51 64 28 52 32 54 58 3 58 53 50 4 59 28 54 2 64 75 61 19 65 39 52 72 62 20 27 56 1 56 35 55 46 43 57 26 59 57 3 24 6 52 43 49 26 64 4 30 66 30 23 3 3 46 54 23 52 72 52 41 27 23 53 52 17 65 52 7 27 33 26 72 52 62
23 2 57 61 25 10 31 59 62 65 18 51 29 0 5 68 4 28 21 63 72 19 57 27 4 52 4 3 39 55 52 66 30 60 65 2 52 1 28 45 3 31 1 33 64 25 59 4 63 5 1 69 64 66 30 53 30 28 70 23 3 33 28 61 50 53 24 60 2 31 61 2 33 23 3 59 51 61 60 47 23 53 66 60 53 0 27 54 56 44 1 1 26 23 43 27 27 59 58 32
62 25 21 44 51 17 27 56 37 25 62 30 26 63 55 70 3 72 26 35 60 30 30 21 28 56 29 26 28 32 31 29 2 26 56 4 54 82 19 61 69 25 21 48 57 56 27 22 32 27 31 20 65 57 27 27 46 67 4 62 61 27 52 62 51 55 60 27 29 3 24 62 29 55 49 58 62 54 60 54 66 21 7 17 49 74 60 7 55 2 0 58 28 69 67 26 35 30 3 25
29 58 4 37 58 3 53 52 2 52 64 22 56 1 26 5 27 31 21 4 30 25 28 69 57 64 1 2 36 49 20 52 49 29 50 57 69 35 29 31 54 45 32 19 27 47 68 33 25 13 54 56 26 58 23 3 47 47 56 51 1 35 57 56 43 21 55 20 39 55 44 31 58 24 33 59 62 49 67 65 15 26 21 23 64 91 57 55 63 1 25 59 4 70 30 50 54 65 61 66
25 68 57 49 24 0 36 2 42 45 27 24 23 51 50 60 1 57 22 60 66 65 34 57 30 2 24 54 70 58 3 66 53 53 51 33 50 1 70 50 55 29 2 68 0 62 44 24 70 1 31 49 65 27 57 22 25 30 29 36 62 32 49 26 26 32 27 29 27 2 28 23 30 1 31 27 50 42 19 62 56 29 8 64 30 64 20 68 55 32 36 29 35 31 63 1 27 33 57 54
51 4 3 60 59 33 53 30 21 4 1 52 55 71 60 3 21 57 21 3 24 50 56 4 1 33 56 1 63 62 64 2 35 30 62 24 56 27 28 2 35 56 1 27 30 54 0 53 64 53 28 61 57 23 52 59 67 61 57 27 26 47 56 1 21 1 26 44 27 63 18 26 1 56 4 72 68 63 41 28 64 29 67 23 3 19 62 52 32 30 23 2 60 27 58 22 65 3 25 32
64 30 82 54 29 30 68 60 62 66 51 38 28 28 23 2 64 65 65 33 31 51 30 29 4 66 3 1 3 2 4 19 33 7 1 3 22 41 21 61 38 21 58 62 28 54 31 59 2 74 75 55 23 2 28 63 67 2 34 63 32 23 31 68 32 62 64 59 31 71 16 2 65 51 26 23 5 4 54 48 22 30 59 3 35 16 65 43 20 60 57 4 62 59 67 24 55 58 52 49
52 31 26 28 21 32 34 33 50 49 28 27 24 74 22 1 30 31 58 27 26 57 75 60 65 58 55 59 20 59 34 61 4 2 28 1 7 23 27 3 67 51 32 48 29 59 19 61 55 29 61 37 50 52 61 18 58 22 59 53 63 0 36 48 55 0 25 63 53 56 3 3 1 26 52 60 33 3 21 53 27 20 57 51 68 30 1 56 43 28 6 32 62 28 52 1 58 3 62 48
57 4 60 17 29 3 47 53 58 51 48 60 58 1 26 67 49 0 21 1 30 31 59 49 3 69 58 64 2 26 44 32 63 33 78 56 24 58 2 58 24 41 26 2 70 62 68 11 24 26 56 65 68 60 3 68 1 2 3 57 72 1 50 42 64 3 2 52 65 56 60 34 28 24 64 36 2 53 3 4 30 66 29 56 62 23 22 48 22 54 23 4 5 28 2 4 3 25 25 73
3 4 34 26 28 80 53 5 4 34 60 21 34 52 9 0 37 26 33 4 62 60 19 26 1 50 63 28 28 23 25 35 61 58 48 54 56 45 50 0 20 42 55 2 21 61 46 27 3 7 71 30 43 1 52 49 34 32 27 64 76 35 67 33 4 51 27 58 25 20 29 1 56 26 51 56 69 54 79 56 32 51 56 50 22 58 31 28 62 63 64 62 28 25 65 64 54 59 64 28
31 62 33 30 2 2 61 62 3 79 29 58 6 69 55 58 53 25 60 48 32 53 52 18 57 27 30 50 42 51 46 1 58 56 28 51 69 59 1 30 25 27 55 26 30 5 55 59 29 42 30 66 69 4 48 62 61 59 72 15 51 57 4 50 65 5 54 63 64 56 20 56 30 45 24 57 33 61 67 69 64 50 32 31 61 1 35 21 42 24 2 41 24 54 52 71 53 2 3 24
50 49 2 23 60 65 26 28 1 33 34 27 45 22 44 62 39 30 2 2 52 33 38 3 47 54 2 0 33 51 74 53 63 62 28 25 56 49 52 49 54 50 4 32 18 65 28 18 45 42 60 4 3 35 47 60 19 65 3 26 57 32 73 74 25 50 28 54 1 63 65 26 50 57 28 3 52 23 31 31 27 66 65 2 62 54 1 50 68 27 31 6 57 65 31 58 3 55 51 36
54 56 25 65 50 24 48 57 27 51 50 65 41 27 23 57 28 53 52 32 72 28 1 3 24 23 75 1 54 57 63 65 34 33 57 69 24 1 32 17 30 3 57 71 3 70 30 56 28 33 68 3 52 1 54 66 60 53 30 28 46 61 38 3 65 68 2 21 40 52 66 57 54 28 2 55 57 30 56 2 63 54 53 34 70 5 59 62 2 56 49 3 53 35 2 31 66 1 60 57
