26 63 36 8 60 48 8 67 27 4 63 63 6 18 22 38 28 49 4 64 55 69 42 0 55 64 27 57 30 2 28 66 54 54 0 44 49 78 44 58 25 48 3 8 44 26 3 35 67 7 20 26 4 59 77 16 45 37 41 62 38 8 22 7 40 39 57 50 39 19 25 36 35 46 46 52 33 12 43 42 5 37 21 64 20 24 34 33 55 26 62 51 58 2 2 4 64 64 45 43
2 59 58 52 3 35 11 62 45 67 8 62 59 34 23 30 57 4 4 4 45 1 55 52 37 35 27 42 38 2 15 26 66 55 36 55 35 43 40 42 66 63 5 68 7 46 51 19 34 57 7 36 38 47 26 55 26 24 48 67 71 34 45 65 72 59 4 8 4 44 46 69 51 18 37 12 45 66 3 1 18 37 38 4 1 40 8 42 30 65 33 55 19 55 14 58 38 50 67 6
7 7 20 51 8 69 28 62 7 66 29 48 52 45 46 71 28 40 0 6 48 71 3 6 73 5 38 65 26 56 17 44 4 26 36 2 3 37 25 48 58 33 3 74 66 33 9 32 8 35 5 45 65 3 55 58 47 3 58 69 4 47 62 77 70 38 23 29 23 44 44 14 3 53 37 25 44 22 59 33 41 46 13 43 5 7 19 64 26 29 6 21 65 47 0 4 5 10 58 23
51 22 75 54 2 3 59 59 38 69 41 10 77 15 43 38 44 39 1 36 66 5 33 24 55 20 26 38 60 27 38 25 66 37 41 37 27 58 46 8 33 9 4 41 35 3 1 26 24 1 2 8 25 7 42 19 7 33 27 5 39 79 4 64 2 41 37 24 19 61 71 54 21 57 55 5 5 41 30 71 5 53 60 22 30 51 43 44 67 52 69 61 40 41 16 57 85 30 48 7
47 67 42 35 43 38 21 27 1 50 3 20 19 73 54 68 73 3 20 42 55 37 52 4 38 72 46 55 4 15 60 60 5 9 0 40 27 69 6 5 61 65 65 47 64 29 55 19 55 7 70 66 46 49 6 64 59 39 7 45 34 26 53 25 41 21 17 29 40 65 7 51 29 63 72 47 2 34 34 50 43 21 9 35 72 4 20 59 54 5 31 41 24 33 38 55 36 7 45 64
57 39 43 63 22 38 5 5 8 3 33 21 41 17 45 23 10 84 7 39 4 66 5 62 23 63 44 55 37 9 6 36 1 64 56 32 38 2 50 52 41 75 4 32 38 3 3 66 18 24 37 47 32 66 5 60 5 69 57 28 25 6 67 45 5 57 29 37 65 70 57 41 34 3 62 63 62 58 45 3 6 60 73 45 67 52 20 19 6 46 36 61 39 6 53 20 1 80 33 1
1 69 49 29 42 48 5 73 37 45 16 84 32 7 41 70 3 9 41 65 42 41 13 22 65 63 34 57 45 7 34 15 37 3 32 46 51 76 32 45 66 23 34 34 44 3 35 76 25 46 65 23 38 2 55 39 8 8 13 36 40 52 51 35 32 5 32 69 23 5 6 33 40 36 19 42 16 35 37 21 17 39 64 5 33 5 45 3 65 72 13 37 58 34 70 45 60 58 9 46
2 43 62 59 7 72 45 42 49 74 47 55 71 5 17 7 63 26 43 5 44 68 1 6 37 58 42 29 54 2 26 26 70 51 6 53 7 43 40 20 64 68 72 8 43 51 22 44 63 39 63 53 12 43 41 46 59 66 64 27 2 62 7 10 6 22 4 39 65 4 35 59 3 38 39 69 51 5 73 37 5 4 1 37 36 41 40 22 8 22 63 39 38 21 41 61 39 52 6 62
39 38 64 58 35 47 38 49 38 39 39 23 63 6 2 33 4 44 17 5 38 5 3 29 47 22 4 35 8 44 49 43 62 8 6 68 25 71 4 19 75 39 10 2 36 44 28 46 60 5 35 66 8 25 55 48 60 20 41 18 36 41 35 25 4 6 24 55 8 4 38 64 38 36 73 57 39 76 17 6 4 6 49 75 75 70 2 67 33 6 3 46 20 55 5 43 21 73 32 1
26 59 4 49 21 50 37 60 44 60 51 21 14 26 39 64 71 40 6 55 39 62 2 1 30 17 56 67 3 7 39 63 3 44 44 21 8 6 46 30 44 74 43 4 61 25 31 69 26 52 53 24 60 65 33 5 71 66 72 19 52 20 56 1 24 7 52 35 43 30 47 67 44 78 9 62 58 24 58 26 38 70 40 62 65 39 54 70 36 43 22 18 44 23 41 42 57 2 60 21
34 68 20 22 1 23 53 66 31 44 45 50 57 4 40 44 4 59 2 43 31 69 41 20 3 39 51 33 52 22 68 3 50 64 56 40 1 31 29 59 9 25 38 2 6 67 43 8 47 43 36 4 60 70 26 31 32 38 72 44 41 24 46 63 37 27 22 19 24 45 4 46 47 36 68 20 47 53 74 3 59 2 65 56 57 39 33 2 41 3 67 35 24 58 57 7 1 45 5 33
4 23 52 1 55 33 17 41 43 24 31 20 53 44 71 68 37 7 4 5 64 45 42 79 70 66 18 75 31 8 32 49 59 59 54 60 34 4 32 41 36 62 42 64 68 32 65 19 8 59 17 7 40 61 45 26 6 2 36 37 0 19 42 58 53 41 32 38 33 35 69 26 35 21 66 25 29 20 39 4 4 37 40 55 36 37 38 40 50 60 74 3 44 5 64 39 46 5 21 5
43 23 0 72 55 49 79 42 66 45 57 46 30 60 68 43 38 54 7 31 23 35 3 3 39 47 47 55 9 46 27 50 68 16 5 64 44 1 9 70 42 5 41 43 41 43 38 4 51 9 14 57 6 5 26 24 43 32 45 8 39 5 40 26 57 41 18 24 39 23 38 63 40 26 4 4 58 45 46 34 28 6 54 63 60 24 43 14 35 63 59 16 3 17 5 42 4 60 54 45
44 79 25 22 37 60 54 20 50 45 67 70 40 65 53 39 38 41 70 57 40 55 3 27 5 26 8 22 64 36 47 63 57 8 5 76 61 20 50 45 59 25 24 39 69 45 24 31 40 49 42 4 41 47 42 68 70 33 52 54 7 3 42 4 9 44 40 6 52 36 34 4 26 53 66 67 33 61 73 24 52 62 54 19 63 45 23 61 51 38 5 4 43 9 25 2 61 30 52 76
22 49 33 16 72 38 65 30 39 3 38 70 46 43 35 69 58 23 68 50 59 63 61 53 19 7 37 53 68 44 5 41 40 40 67 2 66 27 6 22 52 1 28 37 50 51 3 7 3 3 70 70 60 66 5 5 56 38 52 70 30 39 45 61 56 9 42 36 56 60 66 54 64 23 31 38 5 56 66 4 44 28 49 60 2 42 24 31 23 23 3 5 66 60 39 19 5 26 39 23
44 56 60 41 5 5 66 35 38 42 60 47 13 3 72 31 21 4 62 16 3 55 58 65 65 5 35 39 68 55 18 20 46 42 43 40 61 3 71 41 22 62 36 3 69 68 55 24 27 64 34 7 54 33 48 60 50 24 55 6 41 42 1 69 45 64 21 27 35 5 5 62 47 9 63 38 43 39 68 69 7 77 2 40 43 66 46 50 18 39 56 14 57 34 42 46 8 43 7 77
41 2 41 53 37 6 42 25 38 33 70 16 19 9 37 55 41 24 36 7 36 38 42 70 1 33 65 16 46 5 22 20 66 4 52 60 40 28 60 43 40 22 20 4 60 54 20 64 23 43 5 9 17 4 41 29 36 54 49 46 63 46 3 4 54 47 49 65 35 59 20 23 49 5 74 5 40 48 7 39 22 49 27 5 4 6 2 3 41 54 54 32 34 64 41 82 4 32 3 34
20 4 40 36 8 59 52 4 61 49 2 49 65 5 60 5 4 55 11 34 43 47 54 6 38 24 73 21 16 62 58 70 9 28 23 2 39 60 68 43 5 18 19 45 69 64 70 5 9 56 59 48 56 37 36 48 51 55 50 39 5 50 43 23 4 59 35 16 3 30 19 65 49 6 56 21 48 68 57 49 4 75 57 32 51 68 56 52 73 64 43 51 36 9 8 5 60 31 27 10
4 5 49 2 68 30 44 37 25 42 30 23 4 23 6 27 23 38 52 22 43 41 1 29 14 7 52 65 4 46 37 10 32 4 67 35 41 46 43 8 78 41 72 72 5 3 58 43 30 5 26 71 55 7 45 67 4 38 45 25 16 1 46 56 6 62 35 21 55 1 10 63 48 65 60 62 48 43 38 45 7 33 38 1 54 6 7 37 44 37 34 18 85 26 1 61 2 39 37 28
53 60 46 54 38 40 5 24 56 33 46 38 42 62 61 3 48 47 57 20 45 44 39 61 9 53 20 61 45 18 4 39 48 45 5 60 11 2 31 40 44 24 1 36 69 3 69 41 18 4 65 72 5 41 45 41 21 79 38 6 4 23 20 4 64 70 38 52 20 72 35 35 65 67 64 7 42 5 38 59 48 5 22 46 26 58 77 69 18 6 5 32 17 77 52 19 55 53 4 3
51 1 41 35 67 36 55 20 14 71 4 24 8 40 47 43 64 20 24 40 77 42 20 31 41 4 34 30 41 21 3 28 48 61 74 27 5 7 9 11 33 65 5 35 64 22 66 61 39 2 46 27 69 48 44 36 52 64 8 49 5 34 53 25 60 19 65 65 27 64 62 22 58 47 6 61 7 35 48 55 19 37 78 39 28 56 44 3 6 70 58 63 42 44 9 43 65 19 19 30
61 38 63 66 6 44 7 3 23 40 49 49 28 39 37 43 4 45 28 30 31 60 39 7 56 3 20 20 29 2 69 46 56 59 54 4 61 31 58 31 40 61 77 1 15 41 7 63 35 32 42 35 58 66 35 61 47 12 48 49 67 46 34 21 46 31 73 40 20 63 44 1 23 42 37 36 8 74 1 38 61 30 73 38 6 37 63 64 0 16 32 4 44 5 63 26 62 84 38 43
64 65 6 58 67 29 52 4 48 61 4 11 18 38 53 39 11 40 53 43 57 70 44 33 60 42 6 7 54 39 54 5 21 4 43 63 7 56 43 22 38 35 22 27 50 37 32 63 49 10 5 34 72 33 6 73 34 16 78 61 75 74 30 24 5 17 3 52 6 25 12 63 25 37 37 62 51 35 38 39 21 33 62 16 51 47 26 62 59 61 40 6 68 52 46 31 55 2 0 68
39 36 9 30 8 27 42 42 2 21 35 5 62 3 46 58 24 58 38 17 9 60 48 25 35 53 3 39 33 22 48 58 22 59 26 42 58 78 38 5 44 35 23 43 19 41 35 35 4 69 53 49 45 6 41 37 44 55 48 60 53 21 1 45 38 38 53 20 5 52 37 50 23 58 67 25 40 56 67 4 5 60 27 46 68 43 4 44 33 35 76 19 3 65 6 58 24 30 4 7
59 76 55 3 47 25 44 49 39 41 68 29 5 39 60 2 60 62 64 10 22 40 40 32 31 52 77 26 78 35 72 64 2 36 24 69 9 45 5 4 42 4 48 67 60 31 2 40 31 39 7 50 34 51 43 50 55 10 36 1 5 5 53 42 30 8 7 50 48 63 25 31 68 19 22 57 40 36 24 35 71 33 46 9 33 42 62 4 23 31 42 50 43 32 33 26 39 45 32 66
72 5 44 15 18 26 8 82 60 58 21 46 24 23 76 50 50 35 57 25 50 31 51 58 52 62 7 66 9 31 30 46 53 65 40 73 38 52 53 22 66 46 68 45 38 57 55 57 17 23 1 4 46 22 59 6 72 1 56 39 54 37 25 28 76 4 27 4 7 20 43 7 19 3 74 57 53 34 46 52 54 0 41 43 71 8 2 67 56 35 27 5 64 57 68 8 37 35 3 58
66 37 7 10 51 80 72 65 47 31 22 36 38 35 48 2 3 3 73 47 27 76 51 64 24 6 18 20 68 1 51 64 60 68 3 40 60 35 4 32 47 3 34 57 5 28 4 5 23 71 21 4 44 46 51 64 44 36 42 74 7 71 4 36 67 4 77 48 47 38 66 32 37 42 3 57 61 3 37 26 20 8 29 34 26 67 67 27 46 59 4 41 53 47 48 40 8 51 4 24
62 3 3 2 57 24 6 23 74 45 7 56 57 44 43 33 72 63 17 66 74 9 41 6 66 48 23 22 37 59 40 33 49 45 42 47 27 67 23 17 3 43 42 20 57 47 31 55 20 40 65 6 67 34 23 40 47 40 70 59 36 23 55 31 76 53 37 21 46 49 74 31 28 38 58 40 36 40 2 5 72 73 62 49 4 52 24 39 57 53 5 52 58 38 25 26 64 42 69 60
43 52 4 4 42 42 23 67 38 47 2 6 50 69 32 26 7 47 23 45 34 73 5 4 41 50 56 60 36 57 68 55 26 27 68 44 35 3 28 61 20 29 67 2 25 56 62 37 41 49 20 24 26 58 31 8 70 55 20 56 47 35 7 38 40 77 60 19 40 16 41 37 32 55 7 24 4 56 6 7 51 64 21 22 62 42 49 66 24 18 47 47 55 32 27 50 33 4 72 57
39 4 39 60 39 4 37 5 47 40 48 71 67 54 24 57 52 34 24 24 3 5 64 18 70 7 69 47 57 7 73 60 34 60 76 43 78 71 22 42 51 48 21 7 70 23 2 65 8 29 17 35 41 66 45 23 76 49 33 43 11 38 7 41 44 34 27 45 67 30 20 39 17 62 9 19 32 44 56 40 70 43 24 2 5 20 65 55 21 65 36 49 12 20 48 40 46 55 31 68
24 66 38 3 63 67 24 7 2 31 18 62 1 6 65 41 69 48 20 26 53 39 35 42 64 43 41 43 23 75 49 70 70 25 19 64 5 56 5 47 19 52 44 3 41 32 53 6 68 63 27 48 58 18 30 65 32 66 2 5 52 42 59 39 38 3 4 3 59 22 4 11 26 7 73 33 36 42 40 62 27 68 4 35 36 56 19 49 41 36 3 34 40 64 49 42 26 40 44 39
40 59 4 4 67 38 50 48 30 8 48 42 19 59 42 70 23 43 56 46 32 71 46 45 25 61 4 48 58 45 67 42 22 41 66 41 48 69 49 37 6 24 70 8 62 62 5 1 38 41 25 57 2 58 37 39 19 38 59 73 65 7 37 43 43 3 57 61 62 57 41 23 37 15 41 60 63 1 38 43 46 59 20 3 5 55 2 52 7 30 5 1 65 58 66 50 35 30 6 35
58 20 57 41 80 44 5 70 62 0 35 68 2 46 43 37 5 41 38 40 33 40 7 85 37 39 37 35 55 36 3 44 39 43 58 36 35 61 34 37 20 6 45 40 50 9 3 63 7 60 66 52 19 5 74 67 27 51 35 60 2 42 5 19 57 65 49 27 53 33 6 36 62 50 43 36 43 64 41 75 9 72 39 73 21 78 38 58 40 82 22 43 36 15 67 43 16 24 38 19
47 43 7 40 58 50 4 37 4 18 31 63 31 45 42 10 27 62 66 75 24 64 50 65 48 71 61 22 46 33 72 66 3 2 61 6 5 40 37 62 69 63 34 3 9 57 51 17 4 67 23 53 20 5 61 57 26 64 72 40 6 28 3 5 47 23 60 43 50 64 64 3 2 10 48 41 46 34 26 41 75 45 49 5 80 8 68 52 36 4 62 46 19 3 35 39 6 41 45 31
21 26 40 57 4 1 59 43 40 32 6 12 27 41 22 45 27 4 1 31 21 35 45 39 72 66 41 5 65 56 41 64 38 39 64 29 39 6 49 51 40 64 39 9 65 50 40 6 29 47 51 53 38 78 2 25 1 25 4 7 3 3 2 44 18 7 49 35 6 47 58 13 3 17 42 54 2 27 22 39 38 4 3 61 19 5 17 63 54 65 25 4 65 37 43 4 48 15 35 30
59 38 31 3 1 25 31 83 3 50 68 64 6 32 71 69 67 14 36 4 39 54 32 9 45 52 58 19 0 68 2 54 53 38 27 50 40 6 6 62 5 53 22 7 18 39 4 4 45 42 19 61 44 31 52 66 48 69 37 6 8 32 60 5 51 5 27 77 47 48 1 18 42 4 32 75 36 24 45 46 61 48 8 23 1 3 37 33 62 5 30 62 47 59 73 57 40 3 3 29
43 41 64 49 33 22 58 50 18 38 57 40 44 48 1 45 38 26 4 71 55 75 69 52 32 43 59 2 73 63 64 23 25 6 3 44 23 65 53 67 2 50 62 23 42 2 50 58 19 42 10 56 63 36 7 30 29 56 60 68 48 19 44 56 8 62 74 5 21 41 19 59 48 68 61 30 61 31 39 20 40 67 34 22 6 21 44 59 51 52 42 4 3 65 60 59 42 53 10 41
2 56 63 37 4 33 26 67 7 9 67 46 25 22 65 45 53 16 39 7 76 69 41 21 22 64 43 59 37 29 25 6 37 75 20 60 24 4 55 42 33 20 63 70 49 43 38 35 3 69 43 30 37 55 51 72 41 8 11 45 23 48 46 59 4 53 68 71 27 2 42 72 56 20 39 58 69 50 70 39 19 45 24 43 46 48 4 9 51 54 43 1 26 61 48 31 3 43 41 6
43 59 48 5 80 42 28 0 58 4 23 35 35 68 25 45 51 21 26 36 27 22 66 59 3 43 17 42 54 24 41 30 49 38 64 69 7 45 26 26 39 50 41 56 54 58 61 60 4 59 34 4 38 6 19 17 50 63 4 36 59 34 2 46 24 76 3 32 66 40 4 43 4 57 62 3 36 48 61 65 42 9 44 48 35 42 57 32 53 39 5 71 3 42 35 4 14 57 20 37
68 4 70 67 55 42 71 39 26 2 9 6 16 55 42 41 6 53 1 43 76 33 1 19 2 6 56 59 5 50 38 39 32 2 2 61 49 45 70 27 31 30 66 33 68 57 39 22 46 69 3 4 39 6 23 31 3 23 6 55 1 66 43 72 5 68 31 56 37 63 3 2 42 34 38 6 0 55 19 38 34 34 31 46 25 71 32 26 19 63 69 41 20 35 28 8 4 26 53 50
6 21 25 42 37 36 59 29 56 44 37 3 49 21 17 40 9 43 30 46 32 35 64 42 62 44 36 22 6 38 60 31 61 18 46 42 63 22 66 2 66 28 16 5 36 47 39 23 31 48 48 7 74 4 52 66 28 75 42 54 54 43 54 6 62 36 36 26 70 55 44 40 18 70 65 43 8 38 61 45 58 18 29 63 5 5 14 44 66 75 43 47 69 1 1 66 27 37 1 31
50 35 50 28 37 45 46 42 3 38 63 42 14 5 40 37 32 71 66 34 47 48 51 49 42 26 4 30 8 70 25 55 47 46 67 36 23 58 4 67 54 36 57 1 6 42 80 6 6 44 40 46 66 3 48 6 7 18 43 28 34 36 46 36 55 41 62 57 70 2 54 5 53 23 33 37 4 46 30 2 28 53 4 68 9 18 51 81 46 3 9 53 6 69 4 56 63 1 36 50
59 18 41 66 30 64 32 47 56 4 22 51 47 35 40 3 51 41 56 25 66 12 20 17 38 12 35 6 64 40 56 6 42 42 64 22 6 12 7 71 2 74 4 43 6 59 5 47 63 50 6 16 65 4 10 31 3 56 5 62 54 65 3 72 41 67 43 30 17 19 45 55 5 57 59 53 74 64 47 35 20 42 3 21 30 22 3 64 68 62 4 58 60 70 56 61 18 38 17 2
52 8 37 43 23 30 71 26 5 58 2 3 58 7 3 30 2 48 52 52 71 56 24 50 5 55 61 61 13 5 34 25 54 50 47 31 31 37 64 8 77 46 7 42 46 53 4 36 0 42 5 23 62 38 19 64 8 59 51 38 40 6 43 69 59 55 2 19 71 28 72 0 34 40 59 1 40 63 67 27 52 2 74 7 48 11 33 37 20 4 62 40 63 30 40 6 41 47 3 32
47 34 6 5 37 40 17 46 52 63 45 75 42 45 6 34 70 46 53 38 47 4 81 23 27 52 46 68 48 23 27 62 39 8 33 47 1 3 32 68 42 37 30 50 67 49 29 33 4 63 49 28 6 1 70 36 79 30 65 23 49 46 12 39 54 41 42 20 6 4 59 44 64 40 36 5 31 66 64 46 40 22 65 77 45 66 18 27 37 23 56 46 7 62 44 28 39 66 22 3
41 58 5 23 9 40 48 9 66 57 72 45 61 63 41 40 47 5 20 23 29 9 26 67 79 38 72 6 24 35 29 55 27 45 80 28 48 69 42 7 20 35 57 57 5 16 23 51 52 9 50 14 41 78 38 36 4 36 5 9 44 25 3 42 7 58 52 58 46 57 45 21 50 42 42 38 30 48 45 47 63 41 4 40 34 46 46 3 39 44 58 43 63 34 68 54 83 3 26 20
44 1 29 2 49 39 50 54 57 23 1 3 39 41 9 43 62 36 60 26 52 9 33 67 27 66 43 60 64 37 42 41 5 51 70 22 55 37 43 36 64 52 64 46 4 3 42 68 27 70 56 11 18 39 50 40 61 46 3 61 36 6 46 69 48 5 49 58 1 25 39 3 71 65 64 47 55 45 70 2 15 67 40 0 63 20 74 21 23 61 67 23 28 65 48 63 27 59 73 8
33 1 23 5 40 5 36 34 59 58 54 59 49 48 37 37 41 57 59 17 60 46 50 33 58 5 26 64 36 62 63 29 26 35 23 60 7 29 60 71 62 55 56 39 36 4 3 39 21 40 2 18 70 30 34 76 17 30 0 25 63 42 7 2 62 31 67 39 67 2 29 53 28 74 71 49 52 35 54 47 63 47 58 56 43 58 5 66 73 53 51 45 7 5 5 51 36 52 48 70
4 62 45 17 70 29 70 1 67 22 42 76 40 66 64 31 28 6 47 58 64 2 61 61 62 44 34 40 23 63 73 66 20 50 17 33 36 54 31 28 52 43 39 57 74 24 43 4 6 5 37 6 38 31 48 22 70 66 77 69 41 54 47 48 25 63 26 38 57 65 6 78 60 50 1 2 7 56 27 63 7 35 2 28 58 9 66 24 47 52 12 3 73 3 5 64 34 60 72 51
35 66 22 50 52 2 56 3 55 5 44 49 28 1 44 47 23 3 18 65 61 67 56 26 27 43 48 47 4 66 45 63 58 43 57 65 40 44 48 63 24 23 19 22 45 9 1 65 36 48 37 60 40 66 67 20 3 41 40 38 2 67 89 76 62 70 8 47 64 1 8 45 36 50 66 36 55 58 36 65 44 54 4 4 56 34 2 22 6 59 6 6 2 50 70 36 64 57 11 34
65 34 6 56 49 24 54 3 5 72 69 14 49 73 38 20 5 6 52 56 75 43 22 61 42 34 3 50 67 15 63 41 56 21 41 20 1 7 56 46 22 2 54 46 41 39 51 35 6 34 44 39 58 67 5 2 76 5 48 37 5 40 45 36 63 37 60 59 48 3 2 41 43 8 10 45 50 85 42 58 68 46 32 5 31 52 8 27 6 3 72 44 35 51 39 37 27 70 46 35
40 52 36 41 43 30 48 18 59 39 44 32 44 54 52 47 44 33 22 53 21 59 69 36 32 14 27 28 68 29 57 75 43 49 65 60 38 4 4 6 67 36 20 40 64 45 71 0 37 0 30 46 41 23 40 23 68 7 2 1 68 5 41 3 5 78 0 46 23 21 36 23 36 53 45 4 4 69 49 38 58 38 56 63 21 46 69 35 20 64 4 57 4 43 19 7 20 0 23 20
5 5 58 30 54 52 34 74 41 59 40 5 6 66 38 40 4 42 43 3 38 76 4 53 35 0 34 49 56 45 56 5 37 61 54 21 36 7 70 45 74 26 53 57 61 61 42 36 16 39 42 63 2 7 67 62 43 5 37 70 44 50 50 36 78 47 7 42 4 68 35 2 36 32 18 46 41 35 64 58 6 46 40 6 17 34 75 43 47 5 39 16 25 25 62 51 37 2 18 30
67 19 4 7 40 24 1 71 47 43 26 75 6 40 6 27 63 40 6 59 71 59 71 44 3 41 10 5 45 37 52 29 2 63 41 44 48 39 26 6 37 38 58 46 51 59 44 75 59 34 60 6 59 61 69 3 60 61 65 42 25 43 61 60 9 18 56 37 44 51 45 40 63 44 10 35 44 42 1 34 64 59 41 75 56 65 37 16 56 59 36 37 21 35 23 44 35 40 68 68
65 7 49 34 35 48 55 5 57 38 8 28 40 50 65 41 39 41 48 40 62 3 3 10 55 2 13 45 8 16 33 46 32 60 44 5 29 38 63 3 61 3 3 8 5 61 41 38 28 30 67 49 70 45 41 32 60 22 31 6 49 49 48 67 21 28 63 23 57 50 3 5 63 39 32 38 62 2 39 59 35 67 39 65 74 5 72 22 63 63 21 41 42 51 37 58 67 48 48 73
30 47 68 70 41 28 71 31 2 0 7 70 34 59 22 28 4 52 86 47 24 33 44 6 58 7 18 3 28 62 6 24 52 54 64 3 45 61 65 5 44 57 72 55 7 38 39 41 11 32 34 53 20 27 45 40 3 63 23 4 6 26 26 7 44 62 23 4 31 43 20 31 28 29 5 67 69 29 64 46 80 18 20 3 43 48 40 3 24 20 46 43 5 73 4 54 44 25 21 42
19 39 26 51 55 31 5 23 40 74 30 4 3 8 72 6 36 51 8 27 57 46 53 22 36 64 41 36 39 41 73 2 39 62 35 6 45 63 23 4 70 63 25 37 21 24 36 30 3 57 15 21 61 44 64 2 20 35 26 37 73 7 60 38 45 25 63 3 56 79 43 32 45 1 3 69 58 7 47 7 23 72 36 70 34 60 68 66 46 7 4 35 34 60 37 62 33 37 62 70
48 47 41 32 5 48 15 40 58 21 54 64 34 24 45 30 36 31 21 39 35 20 42 44 39 28 69 30 8 1 41 8 10 41 38 37 71 7 40 41 27 60 73 1 26 6 26 66 86 76 25 32 28 45 40 29 46 56 49 70 1 41 34 24 55 18 9 23 26 43 43 43 4 31 69 51 74 36 57 56 26 56 52 54 41 3 62 23 26 66 2 25 21 76 22 70 41 27 29 4
34 55 21 47 33 52 30 87 36 55 6 74 51 41 19 17 61 21 52 34 46 43 48 14 83 35 23 6 7 62 3 16 65 63 4 27 70 59 22 76 38 5 5 18 25 6 18 38 6 55 4 1 4 27 58 6 6 50 36 7 59 42 55 1 53 6 35 61 8 63 71 39 16 81 28 65 8 21 62 3 35 54 43 50 69 1 32 30 29 70 30 21 33 4 29 65 57 41 20 33
9 8 7 5 80 62 39 34 23 41 16 39 63 33 44 63 65 43 40 6 52 7 4 22 66 17 23 71 63 2 67 40 20 62 5 38 15 37 72 48 53 49 17 6 34 23 19 22 68 55 4 4 45 25 46 3 63 44 55 40 59 24 42 33 74 8 40 41 51 10 40 69 61 38 58 25 5 68 33 18 45 45 8 68 60 11 56 40 46 33 20 59 30 27 22 26 20 38 23 64
50 23 5 5 46 3 69 40 37 67 53 38 3 2 1 24 64 72 36 30 62 8 65 53 42 29 42 2 47 49 42 57 8 32 26 17 40 24 44 43 65 0 20 76 13 8 37 64 58 61 43 4 77 42 20 80 4 5 63 52 21 22 7 42 10 66 7 20 4 45 49 6 26 8 26 74 26 36 69 52 25 56 66 3 3 59 28 18 55 40 41 51 44 31 20 76 59 53 46 39
6 40 56 2 37 67 30 68 4 37 23 32 33 52 65 14 12 32 7 60 9 5 17 67 15 26 24 37 10 3 34 71 31 6 71 36 3 42 5 24 7 36 4 21 3 45 19 51 71 46 40 49 69 37 3 67 45 9 60 16 35 30 21 19 20 64 60 68 72 24 74 8 22 8 2 41 38 7 35 5 38 2 35 17 59 41 51 43 26 44 9 37 13 38 45 63 8 24 73 47
69 27 47 48 58 19 5 47 49 47 28 4 47 4 59 27 16 43 63 8 41 29 51 49 68 55 34 35 9 67 51 69 59 30 24 3 3 63 46 56 42 37 10 47 6 37 43 50 68 53 53 72 4 2 55 29 8 70 39 55 2 70 36 56 62 23 48 57 40 72 35 16 69 54 79 4 54 43 38 48 57 74 61 12 58 66 29 67 33 21 15 5 4 8 63 46 51 39 36 36
43 9 2 36 30 46 65 38 48 42 58 41 60 35 5 42 37 72 8 42 75 67 28 49 20 2 2 19 3 33 43 72 59 67 72 4 41 25 2 44 4 22 67 73 31 34 43 42 75 64 63 37 70 35 4 36 79 7 48 52 24 7 50 2 6 79 44 7 26 59 5 64 26 38 37 34 3 15 58 61 32 4 67 21 29 67 59 27 26 40 37 47 44 23 60 15 8 58 63 37
10 75 14 70 5 51 54 65 4 43 66 32 51 36 62 36 48 26 46 41 54 58 5 24 70 25 5 61 3 6 41 57 54 61 58 32 39 35 37 6 19 53 35 16 8 22 21 57 47 50 40 32 0 51 51 32 19 30 41 5 24 35 58 44 54 49 20 20 7 20 40 37 6 5 43 63 33 59 7 47 62 40 80 36 40 47 39 39 28 39 20 21 28 63 22 60 52 54 58 65
5 5 64 26 5 46 71 41 3 35 60 35 41 45 45 36 39 6 22 27 74 38 2 59 62 4 43 6 51 33 36 38 3 6 66 51 20 61 41 5 53 73 5 34 46 49 63 53 39 67 53 44 2 6 59 34 21 2 51 42 22 38 61 26 46 59 38 44 30 4 5 1 35 5 35 61 43 70 42 18 56 47 6 4 23 5 42 60 36 64 21 18 18 4 3 7 35 48 17 6
44 58 47 53 61 7 59 7 59 3 68 42 7 33 20 74 4 33 4 21 45 8 23 7 47 44 58 45 67 40 37 67 57 20 42 24 35 5 38 35 66 30 50 18 45 45 52 4 71 49 16 41 55 14 32 58 71 56 50 53 6 52 71 37 6 2 68 5 40 38 60 11 66 63 45 55 38 37 20 43 56 4 48 2 38 12 71 54 38 66 2 6 37 27 21 30 45 40 3 7
5 37 45 54 47 40 24 4 32 37 37 18 43 44 24 62 36 27 23 66 37 59 56 39 29 7 58 68 58 39 29 21 46 8 11 44 47 63 7 57 51 5 64 28 54 25 5 70 58 59 41 28 49 68 25 4 55 58 3 26 26 36 67 57 46 61 79 47 41 4 7 25 29 70 23 4 61 64 1 63 52 61 34 42 41 22 66 64 61 6 5 4 51 46 20 28 60 27 41 24
42 43 57 50 31 39 42 4 42 61 23 39 44 31 20 7 22 66 34 43 31 27 83 53 52 45 44 8 26 7 19 65 54 55 75 60 2 63 36 9 58 48 2 8 55 40 18 42 60 30 3 64 9 3 46 41 51 52 43 69 47 26 56 66 17 36 57 47 42 4 1 23 61 8 2 3 40 47 4 76 18 4 8 54 32 45 3 4 38 64 24 34 27 28 30 39 46 6 6 5
20 29 59 37 36 44 5 63 4 49 38 8 75 8 73 43 67 48 34 4 47 23 40 69 6 78 69 5 44 42 24 67 73 65 48 77 58 57 59 73 3 2 46 21 3 6 5 51 69 4 38 63 25 3 42 23 23 57 68 53 64 36 46 40 42 50 24 36 5 56 40 38 3 5 53 22 70 64 77 71 46 20 41 28 47 62 40 70 63 67 74 46 2 10 53 8 7 42 34 67
50 26 55 45 63 66 44 42 24 39 46 40 46 4 8 43 44 3 67 32 37 6 62 61 36 62 36 34 21 66 71 3 51 31 36 3 5 44 41 67 5 17 71 20 16 49 61 42 4 60 45 59 43 3 4 53 51 39 34 27 34 72 23 24 47 22 51 60 37 40 42 36 40 43 70 1 7 40 7 61 53 58 46 32 46 44 23 25 40 65 6 67 48 21 42 5 30 65 19 56
25 47 21 37 63 56 56 3 69 36 44 2 65 51 67 46 37 27 6 40 87 26 59 4 81 47 3 54 57 5 71 2 4 38 44 65 21 29 58 8 68 67 69 40 30 75 33 37 46 11 32 46 6 42 51 50 30 2 26 22 4 53 47 57 67 43 42 6 17 33 37 59 40 44 19 5 21 66 52 37 57 29 39 60 75 48 6 47 45 38 63 2 9 65 63 53 37 23 38 24
4 42 37 22 8 62 53 32 8 62 9 41 3 5 26 1 16 47 67 33 41 51 20 6 46 19 70 63 5 51 60 28 4 41 51 7 49 60 57 33 34 18 9 62 56 22 45 60 41 58 61 26 6 8 19 47 3 20 3 9 4 47 52 73 7 47 5 30 58 2 39 22 34 25 45 22 6 4 21 35 73 31 42 26 70 55 61 62 35 55 5 67 17 21 39 27 57 23 62 36
42 68 4 71 24 19 2 67 30 4 44 5 8 21 25 54 16 35 19 56 19 65 3 60 54 26 34 45 44 6 7 26 45 23 72 56 55 42 58 36 42 31 3 37 7 41 2 67 44 61 35 48 44 46 33 25 57 9 67 45 7 26 4 3 43 6 45 46 24 66 55 58 31 16 8 26 53 22 25 43 57 9 33 32 6 7 69 55 66 5 5 54 46 48 50 22 37 18 35 33
43 69 25 66 28 47 39 40 28 25 38 7 44 21 57 42 66 32 36 2 43 4 22 23 33 29 5 43 47 27 72 12 43 26 63 30 28 5 46 69 67 26 52 57 5 32 65 40 48 43 34 41 58 28 34 21 62 16 25 27 55 50 23 58 7 42 66 60 27 64 27 3 74 35 29 65 7 6 60 52 57 36 67 3 5 53 39 33 62 19 24 6 43 40 10 2 42 3 52 6
21 42 3 70 5 26 63 54 8 50 38 59 59 54 40 48 35 39 2 37 27 27 5 34 8 11 3 66 44 57 72 78 40 18 6 9 67 11 64 38 59 18 39 57 6 63 45 24 37 5 68 44 40 6 6 58 45 44 41 2 6 66 56 63 58 15 44 42 64 31 33 17 66 3 58 48 28 58 30 3 2 77 60 3 4 44 20 51 57 40 45 5 27 7 4 5 59 6 63 3
42 9 29 6 8 61 62 4 69 53 2 29 1 39 25 56 62 3 17 4 7 53 43 28 47 45 7 52 62 29 4 38 37 58 55 11 65 19 63 43 69 9 20 6 32 10 24 17 60 33 53 20 50 38 61 83 32 55 42 18 36 36 2 34 16 21 42 54 60 66 5 25 63 4 70 8 26 4 61 54 65 73 37 28 6 40 58 39 2 47 57 65 4 20 75 26 58 70 37 80
54 70 5 41 25 46 57 26 4 24 64 41 9 26 51 18 47 8 4 35 47 57 67 48 32 35 18 45 18 67 43 25 37 42 3 38 36 1 3 5 62 2 41 35 20 33 20 18 5 54 36 23 45 62 55 29 68 8 36 23 41 23 55 38 22 52 24 40 38 22 3 35 37 58 45 7 72 51 47 44 5 72 5 46 60 40 38 50 47 4 76 43 36 32 50 29 42 3 65 44
40 19 40 46 60 37 3 13 39 47 69 46 77 42 35 0 38 62 63 53 52 7 35 22 3 47 71 54 50 33 20 22 64 2 25 36 47 42 28 55 29 46 57 39 56 46 24 3 78 36 66 31 50 47 47 23 44 4 9 60 65 57 66 44 5 21 23 75 64 71 58 60 39 61 68 52 56 36 70 70 4 43 71 16 44 33 72 51 41 57 7 61 20 27 39 5 62 67 3 39
8 46 3 39 64 66 1 5 27 72 30 74 9 49 4 40 27 41 44 44 50 21 73 17 4 12 32 62 31 36 3 75 43 38 66 39 8 4 1 26 58 22 62 43 54 8 7 57 56 43 55 15 54 68 19 57 35 57 3 39 64 9 25 52 54 59 44 41 70 51 4 59 5 36 65 51 34 28 52 50 82 20 40 9 48 36 63 4 35 37 27 66 67 7 62 62 27 71 60 60
25 67 6 62 20 39 75 61 43 72 63 43 44 8 34 1 55 40 67 32 43 42 5 5 43 45 58 50 37 38 25 15 71 35 79 69 59 28 42 23 3 39 35 60 56 6 48 21 30 0 19 78 57 23 25 45 43 3 26 41 35 49 40 54 68 53 54 69 6 14 44 4 3 41 28 32 34 17 41 61 27 67 49 39 65 28 3 32 4 49 4 59 72 64 29 37 32 54 35 22
51 49 37 50 38 48 46 42 55 54 61 5 39 17 39 3 23 29 53 37 4 38 48 49 41 59 31 46 48 61 5 32 31 4 17 55 38 47 59 40 34 44 31 58 38 32 44 3 58 5 59 60 61 80 64 4 30 4 53 41 32 22 3 59 57 41 24 51 5 71 5 64 65 48 9 45 43 3 35 26 3 34 35 29 37 17 40 29 21 41 71 36 78 22 43 45 55 5 42 51
56 43 54 6 38 44 38 22 42 39 19 51 26 20 34 15 56 39 44 61 5 42 5 3 32 44 21 38 2 4 60 36 50 9 62 44 48 52 46 1 24 28 19 29 60 46 34 38 42 21 63 84 37 3 81 70 5 64 44 5 56 55 74 58 33 4 24 44 42 22 1 38 28 34 49 61 35 7 46 8 4 71 60 10 35 63 46 54 3 4 30 25 49 9 5 20 29 5 42 42
32 30 6 41 67 68 41 5 47 7 79 7 62 46 64 42 19 3 72 62 52 21 23 46 44 27 48 61 19 14 72 46 3 51 20 4 56 70 66 56 4 4 27 4 54 5 42 24 49 50 60 42 7 34 58 50 51 25 1 60 38 78 68 4 52 51 67 28 9 54 68 39 57 59 18 69 43 2 26 8 19 15 9 0 49 61 41 49 5 57 52 34 22 43 21 41 63 26 14 51
71 67 20 67 68 43 43 53 65 59 43 43 3 4 28 47 60 20 6 69 53 70 31 47 68 57 49 46 25 25 70 50 37 46 6 41 3 42 55 88 9 41 21 39 35 9 21 24 60 2 49 5 56 33 54 34 24 34 60 40 25 54 7 6 20 55 62 30 33 11 43 40 68 26 38 61 10 45 38 37 1 50 63 3 47 37 37 24 1 2 28 35 5 47 29 45 74 7 55 6
77 46 57 39 55 44 40 60 5 53 39 57 2 8 66 5 56 41 33 12 40 19 39 19 5 25 33 53 58 26 82 43 72 48 26 43 28 52 18 38 55 45 23 61 55 37 11 50 32 23 44 5 69 64 47 37 4 4 73 69 36 49 42 52 5 16 46 47 51 66 64 22 46 36 53 37 3 44 18 35 44 47 36 36 51 62 49 64 9 57 3 48 25 68 37 5 68 67 54 19
5 4 33 56 5 63 46 66 38 45 27 57 77 6 60 5 4 25 49 72 23 47 35 44 5 25 54 33 33 85 34 40 68 59 4 3 57 17 27 67 24 54 55 66 64 70 36 26 41 30 46 55 63 10 71 20 65 66 67 21 41 45 67 7 53 6 39 38 38 8 24 34 20 40 54 9 4 29 48 73 53 36 34 16 5 8 6 27 3 50 5 47 4 45 48 38 57 60 61 80
65 42 62 60 3 24 5 32 69 39 62 21 36 6 38 44 21 6 45 50 21 3 32 34 88 26 59 65 33 58 43 30 69 4 68 71 29 6 26 43 4 11 65 1 19 58 2 37 61 73 53 42 38 58 8 45 43 26 23 55 17 28 52 58 10 47 4 27 61 19 37 71 5 43 62 32 48 5 5 47 49 34 30 20 66 17 47 40 3 18 39 53 29 7 47 49 43 66 50 19
37 5 61 65 34 42 38 1 21 69 38 58 47 3 9 63 4 40 47 19 4 47 25 29 4 28 7 5 45 77 20 52 48 1 24 5 58 6 46 27 7 46 5 38 25 42 19 8 58 6 3 53 27 1 44 24 33 38 61 41 5 39 43 30 65 64 45 60 5 40 19 8 42 48 7 75 25 4 22 70 27 66 71 61 63 10 40 25 29 23 5 8 39 39 65 45 36 48 63 33
3 44 36 19 71 45 34 22 51 41 21 38 39 65 61 1 7 3 52 46 72 36 46 37 42 58 32 49 45 34 39 44 6 47 71 4 62 1 47 56 63 38 46 67 62 28 31 35 37 56 49 41 63 49 36 42 64 68 5 60 82 44 26 26 22 75 15 36 41 6 35 52 37 55 55 62 1 31 74 58 61 45 2 39 74 59 72 4 23 4 3 74 47 70 62 40 36 51 4 47
28 57 3 52 24 10 59 62 1 59 1 32 15 9 55 8 39 36 52 8 41 48 48 24 22 28 2 5 30 16 37 59 64 45 14 50 61 37 53 36 62 22 40 28 36 59 17 47 47 46 54 19 31 70 35 6 29 21 52 17 7 45 3 2 30 44 53 44 68 57 65 45 51 48 40 70 54 64 66 1 45 34 49 38 26 4 49 70 51 3 52 20 6 62 38 62 15 52 25 61
43 2 27 30 44 5 44 6 24 60 32 37 47 60 75 77 2 24 50 65 73 58 17 21 40 2 45 56 55 75 5 76 71 71 22 45 18 5 52 27 59 44 2 68 4 61 74 42 2 4 44 62 73 36 17 48 49 37 52 40 62 31 21 38 42 43 46 41 35 3 42 46 45 5 42 40 56 19 55 55 61 40 9 76 41 52 46 28 60 30 31 54 48 41 63 5 39 42 69 49
57 5 6 0 66 49 50 36 43 8 2 62 67 63 47 6 49 79 26 6 46 3 17 9 4 49 69 9 56 63 30 3 47 40 65 27 22 50 34 4 35 57 5 36 31 62 9 28 1 67 36 56 23 35 56 56 1 63 59 47 43 21 59 5 42 4 40 16 41 26 32 41 6 61 2 5 68 71 44 45 51 39 66 46 9 44 69 11 31 39 31 5 25 38 54 42 2 3 50 42
77 39 3 14 45 36 42 64 69 72 46 38 29 34 42 3 43 70 59 56 54 19 57 51 7 70 5 2 1 5 3 40 51 3 5 4 51 25 52 57 40 35 29 48 45 54 37 46 8 53 54 21 47 6 38 74 65 7 43 27 28 44 34 23 36 60 54 63 37 44 35 8 69 47 54 36 4 5 53 25 45 34 26 3 45 43 2 64 34 59 63 10 21 56 19 31 65 22 63 1
49 41 48 40 48 34 33 49 67 62 35 42 39 74 43 4 48 36 19 37 47 68 60 55 58 52 16 78 50 58 30 68 4 9 43 6 7 39 34 3 18 21 41 13 43 25 40 56 22 32 67 45 65 19 33 39 30 51 51 68 66 7 45 57 23 4 39 66 67 67 6 6 2 49 19 53 51 1 50 49 42 31 82 22 29 42 2 64 24 53 2 52 63 43 56 7 18 6 2 16
4 4 62 41 35 7 27 3 64 20 27 57 72 8 42 74 57 6 45 4 40 42 55 17 4 60 75 60 7 28 19 26 66 45 23 26 43 58 2 68 45 18 27 9 58 53 25 29 38 32 67 65 63 14 4 21 4 8 3 55 17 3 77 21 74 3 3 21 20 31 76 44 43 46 27 47 5 21 5 8 38 66 48 23 17 47 38 65 50 53 35 5 7 54 3 5 5 51 36 5
6 6 41 39 51 51 14 8 6 44 22 47 46 50 8 6 36 44 34 3 63 13 40 46 7 76 58 43 41 35 38 37 54 29 3 71 27 41 53 5 34 65 66 9 38 50 68 44 5 2 73 37 20 4 28 68 31 45 53 58 46 44 57 39 4 67 34 61 37 46 33 6 56 30 16 52 4 62 4 62 37 64 18 67 47 48 44 50 20 70 50 30 35 43 67 72 58 28 25 39
33 68 34 48 3 2 59 56 7 76 26 64 5 49 26 64 69 42 63 21 36 68 58 42 49 33 40 14 41 20 14 9 26 66 31 18 71 2 3 40 38 44 19 45 29 7 54 48 42 65 37 64 80 4 23 2 68 33 70 34 20 19 7 76 25 8 20 4 57 68 45 17 54 23 31 58 35 7 19 49 59 64 37 43 4 7 43 34 26 42 9 17 49 24 20 59 24 5 2 37
26 55 5 41 12 19 40 46 3 36 43 46 26 35 30 63 39 41 1 6 23 42 28 7 64 25 3 9 47 62 61 52 70 25 39 40 2 66 21 15 67 20 3 45 45 61 50 36 24 12 63 5 7 50 56 22 49 67 4 28 24 38 60 3 33 24 48 63 5 58 75 38 57 27 38 14 0 35 62 40 36 74 26 5 49 61 3 26 63 39 42 4 53 60 43 54 5 61 26 43
69 77 39 50 21 34 54 20 39 64 69 62 60 44 41 57 29 29 66 44 47 37 3 3 46 28 62 3 54 25 23 23 37 42 61 21 41 6 59 48 40 3 63 55 3 55 41 17 41 35 50 8 56 4 62 63 73 43 46 41 60 40 30 7 69 62 4 54 15 25 6 71 50 54 6 65 63 38 68 8 2 3 21 26 5 4 57 60 4 64 34 4 53 38 8 49 74 4 67 60
